ateco_2007_5cifre;descrizione_ateco_2007_5cifre;dimensione_impresa;num_imprese;tot_addetti;tot_dipendenti;tot_indipendenti;tot_esterni;tot_interinali
1610;Attività di supporto alla produzione vegetale;Micro;10;30;18;12;0;0
1620;Attività di supporto alla produzione animale (esclusi i servizi veterinari);Micro;7;11;4;7;0;0
1620;Attività di supporto alla produzione animale (esclusi i servizi veterinari);Piccola;1;19;18;1;0;0
1630;Attività che seguono la raccolta;Micro;5;6;3;3;0;0
2100;Silvicoltura e altre attività forestali;Micro;6;5;1;4;0;0
2200;Utilizzo di aree forestali;Micro;4;5;3;2;0;0
2400;Servizi di supporto per la silvicoltura;Micro;3;2;0;2;0;0
3110;Pesca in acque marine e lagunari e servizi connessi;Micro;1;7;7;0;1;0
3120;Pesca in acque dolci e servizi connessi;Micro;2;5;1;4;0;0
3210;Acquacoltura in acqua di mare, salmastra o lagunare e servizi connessi;Micro;1;0;0;0;0;0
3220;Acquacoltura in acque dolci e servizi connessi;Micro;2;6;3;3;0;0
6200;Estrazione di gas naturale;Piccola;2;92;92;0;2;0
7290;Estrazione di altri minerali metalliferi non ferrosi;Micro;1;1;1;0;0;0
8110;Estrazione di pietre ornamentali e da costruzione, calcare, pietra da gesso, creta e ardesia;Micro;3;17;12;5;1;0
8110;Estrazione di pietre ornamentali e da costruzione, calcare, pietra da gesso, creta e ardesia;Piccola;1;10;10;0;1;0
8120;Estrazione di ghiaia, sabbia| estrazione di argille e caolino;Media;1;51;51;0;2;0
8120;Estrazione di ghiaia, sabbia| estrazione di argille e caolino;Micro;11;22;19;3;1;0
8120;Estrazione di ghiaia, sabbia| estrazione di argille e caolino;Piccola;5;82;79;3;6;0
8990;Estrazione di altri minerali nca;Media;1;106;105;1;1;0
8990;Estrazione di altri minerali nca;Piccola;1;20;20;0;4;0
9100;Attività di supporto all'estrazione di petrolio e di gas naturale;Micro;3;7;7;0;0;0
9100;Attività di supporto all'estrazione di petrolio e di gas naturale;Piccola;2;48;48;0;0;0
10110;Produzione di carne non di volatili e di prodotti della macellazione (attività dei mattatoi);Media;5;362;361;1;1;0
10110;Produzione di carne non di volatili e di prodotti della macellazione (attività dei mattatoi);Micro;9;12;9;3;1;0
10110;Produzione di carne non di volatili e di prodotti della macellazione (attività dei mattatoi);Piccola;11;329;319;10;1;0
10120;Produzione di carne di volatili e prodotti della loro macellazione (attività dei mattatoi);Micro;1;1;0;1;0;0
10130;Produzione di prodotti a base di carne (inclusa la carne di volatili);Media;2;291;289;2;0;0
10130;Produzione di prodotti a base di carne (inclusa la carne di volatili);Micro;6;16;11;5;0;0
10130;Produzione di prodotti a base di carne (inclusa la carne di volatili);Piccola;7;176;161;15;0;0
10200;Lavorazione e conservazione di pesce, crostacei e molluschi mediante surgelamento, salatura eccetera;Micro;1;0;0;0;0;0
10310;Lavorazione e conservazione delle patate;Media;1;85;85;0;0;48
10320;Produzione di succhi di frutta e di ortaggi;Media;1;60;58;2;8;0
10320;Produzione di succhi di frutta e di ortaggi;Micro;1;1;0;1;0;0
10390;Lavorazione e conservazione di frutta e di ortaggi (esclusi i succhi di frutta e di ortaggi);Media;1;56;55;1;2;6
10390;Lavorazione e conservazione di frutta e di ortaggi (esclusi i succhi di frutta e di ortaggi);Micro;6;13;7;6;0;0
10390;Lavorazione e conservazione di frutta e di ortaggi (esclusi i succhi di frutta e di ortaggi);Piccola;1;26;25;1;0;0
10411;Produzione di olio di oliva da olive prevalentemente non di produzione propria;Micro;1;2;0;2;0;0
10412;Produzione di olio raffinato o grezzo da semi oleosi o frutti oleosi prevalentemente non di produzione propria;Micro;1;0;0;0;0;0
10412;Produzione di olio raffinato o grezzo da semi oleosi o frutti oleosi prevalentemente non di produzione propria;Piccola;2;53;51;2;3;0
10420;Produzione di margarina e di grassi commestibili simili;Piccola;1;27;26;1;3;0
10511;Trattamento igienico del latte;Piccola;1;17;15;2;2;0
10512;Produzione dei derivati del latte;Grande;2;2207;2207;0;18;138
10512;Produzione dei derivati del latte;Media;3;230;228;2;2;0
10512;Produzione dei derivati del latte;Micro;8;26;22;4;4;0
10512;Produzione dei derivati del latte;Piccola;7;158;148;10;10;5
10520;Produzione di gelati senza vendita diretta al pubblico;Micro;6;14;7;7;0;0
10612;Molitura di altri cereali;Micro;3;13;8;5;0;0
10613;Lavorazione del riso;Micro;2;0;0;0;0;0
10613;Lavorazione del riso;Piccola;1;24;22;2;0;0
10614;Altre lavorazioni di semi e granaglie;Micro;2;6;6;0;0;6
10620;Produzione di amidi e di prodotti amidacei (inclusa produzione di olio di mais);Micro;1;4;2;2;0;0
10711;Produzione di prodotti di panetteria freschi;Media;1;70;69;1;0;0
10711;Produzione di prodotti di panetteria freschi;Micro;419;1511;769;742;9;1
10711;Produzione di prodotti di panetteria freschi;Piccola;40;611;533;78;7;18
10712;Produzione di pasticceria fresca;Media;1;60;60;0;2;8
10712;Produzione di pasticceria fresca;Micro;51;166;92;74;5;1
10712;Produzione di pasticceria fresca;Piccola;11;157;130;27;2;1
10720;Produzione di fette biscottate, biscotti| prodotti di pasticceria conservati;Media;1;184;181;3;5;0
10720;Produzione di fette biscottate, biscotti| prodotti di pasticceria conservati;Micro;7;17;15;2;2;0
10720;Produzione di fette biscottate, biscotti| prodotti di pasticceria conservati;Piccola;3;52;52;0;0;3
10730;Produzione di paste alimentari, di cuscus e di prodotti farinacei simili;Media;1;71;71;0;0;0
10730;Produzione di paste alimentari, di cuscus e di prodotti farinacei simili;Micro;30;73;30;43;0;0
10730;Produzione di paste alimentari, di cuscus e di prodotti farinacei simili;Piccola;3;84;80;4;1;15
10820;Produzione di cacao in polvere, cioccolato, caramelle e confetterie;Grande;1;3462;3462;0;2;67
10820;Produzione di cacao in polvere, cioccolato, caramelle e confetterie;Media;2;235;235;0;6;0
10820;Produzione di cacao in polvere, cioccolato, caramelle e confetterie;Micro;15;54;30;24;3;0
10820;Produzione di cacao in polvere, cioccolato, caramelle e confetterie;Piccola;5;87;81;6;0;1
10830;Lavorazione del tè e del caffè;Media;1;132;132;0;0;0
10830;Lavorazione del tè e del caffè;Micro;11;43;28;15;3;0
10830;Lavorazione del tè e del caffè;Piccola;7;157;144;13;10;0
10840;Produzione di condimenti e spezie;Micro;3;7;4;3;0;0
10840;Produzione di condimenti e spezie;Piccola;2;63;60;3;3;0
10850;Produzione di pasti e piatti pronti (preparati, conditi, cucinati e confezionati);Micro;21;60;35;25;1;0
10850;Produzione di pasti e piatti pronti (preparati, conditi, cucinati e confezionati);Piccola;1;12;10;2;7;0
10860;Produzione di preparati omogeneizzati e di alimenti dietetici;Grande;1;758;758;0;7;13
10860;Produzione di preparati omogeneizzati e di alimenti dietetici;Media;1;243;243;0;7;0
10860;Produzione di preparati omogeneizzati e di alimenti dietetici;Micro;8;20;18;2;2;0
10860;Produzione di preparati omogeneizzati e di alimenti dietetici;Piccola;1;11;9;2;1;0
10890;Produzione di prodotti alimentari nca;Media;1;51;51;0;0;0
10890;Produzione di prodotti alimentari nca;Micro;42;76;47;29;8;0
10890;Produzione di prodotti alimentari nca;Piccola;7;158;149;9;3;12
10910;Produzione di mangimi per l'alimentazione degli animali da allevamento;Media;1;52;52;0;4;0
10910;Produzione di mangimi per l'alimentazione degli animali da allevamento;Micro;6;5;5;0;1;0
10920;Produzione di prodotti per l'alimentazione degli animali da compagnia;Micro;2;11;9;2;0;0
10920;Produzione di prodotti per l'alimentazione degli animali da compagnia;Piccola;1;19;19;0;1;8
11010;Distillazione, rettifica e miscelatura degli alcolici;Media;2;236;235;1;20;3
11010;Distillazione, rettifica e miscelatura degli alcolici;Micro;4;12;9;3;3;0
11021;Produzione di vini da tavola e v.q.p.r.d.;Media;1;108;107;1;1;0
11021;Produzione di vini da tavola e v.q.p.r.d.;Micro;7;32;28;4;0;0
11021;Produzione di vini da tavola e v.q.p.r.d.;Piccola;1;13;11;2;3;0
11050;Produzione di birra;Grande;1;919;919;0;1;13
11050;Produzione di birra;Micro;5;4;0;4;1;0
11050;Produzione di birra;Piccola;1;24;24;0;4;0
11070;Industria delle bibite analcoliche, delle acque minerali e di altre acque in bottiglia;Grande;2;4641;4641;0;9;54
11070;Industria delle bibite analcoliche, delle acque minerali e di altre acque in bottiglia;Media;2;464;464;0;2;4
11070;Industria delle bibite analcoliche, delle acque minerali e di altre acque in bottiglia;Micro;3;3;3;0;0;2
11070;Industria delle bibite analcoliche, delle acque minerali e di altre acque in bottiglia;Piccola;2;48;46;2;18;0
13100;Preparazione e filatura di fibre tessili;Media;5;528;526;2;17;4
13100;Preparazione e filatura di fibre tessili;Micro;8;17;13;4;2;0
13100;Preparazione e filatura di fibre tessili;Piccola;9;208;198;10;9;1
13200;Tessitura;Media;3;286;283;3;6;18
13200;Tessitura;Micro;18;46;30;16;5;0
13200;Tessitura;Piccola;6;123;120;3;5;2
13300;Finissaggio dei tessili, degli articoli di vestiario e attività similari;Media;3;315;311;4;7;1
13300;Finissaggio dei tessili, degli articoli di vestiario e attività similari;Micro;21;27;17;10;2;0
13300;Finissaggio dei tessili, degli articoli di vestiario e attività similari;Piccola;10;260;252;8;7;5
13910;Fabbricazione di tessuti a maglia;Micro;4;10;6;4;0;0
13910;Fabbricazione di tessuti a maglia;Piccola;3;89;86;3;22;0
13921;Confezionamento di biancheria da letto, da tavola e per l'arredamento;Grande;1;272;272;0;2;0
13921;Confezionamento di biancheria da letto, da tavola e per l'arredamento;Micro;57;128;51;77;1;0
13921;Confezionamento di biancheria da letto, da tavola e per l'arredamento;Piccola;3;37;33;4;0;0
13922;Fabbricazione di articoli in materie tessili nca;Micro;44;77;29;48;5;0
13922;Fabbricazione di articoli in materie tessili nca;Piccola;3;52;50;2;2;0
13930;Fabbricazione di tappeti e moquette;Micro;4;4;0;4;1;0
13940;Fabbricazione di spago, corde, funi e reti;Micro;3;14;10;4;2;0
13940;Fabbricazione di spago, corde, funi e reti;Piccola;2;24;21;3;1;0
13950;Fabbricazione di tessuti non tessuti e di articoli in tali materie (esclusi gli articoli di abbigliamento);Grande;1;380;380;0;10;0
13950;Fabbricazione di tessuti non tessuti e di articoli in tali materie (esclusi gli articoli di abbigliamento);Micro;2;4;4;0;0;0
13950;Fabbricazione di tessuti non tessuti e di articoli in tali materie (esclusi gli articoli di abbigliamento);Piccola;1;22;22;0;2;0
13961;Fabbricazione di nastri, etichette e passamanerie di fibre tessili;Micro;8;21;13;8;3;0
13961;Fabbricazione di nastri, etichette e passamanerie di fibre tessili;Piccola;4;79;72;7;2;0
13962;Fabbricazione di altri articoli tessili tecnici ed industriali;Media;1;50;50;0;0;0
13962;Fabbricazione di altri articoli tessili tecnici ed industriali;Micro;52;76;37;39;4;0
13962;Fabbricazione di altri articoli tessili tecnici ed industriali;Piccola;9;193;185;8;7;2
13991;Fabbricazione di ricami;Micro;14;34;16;18;1;0
13991;Fabbricazione di ricami;Piccola;3;40;33;7;0;0
13992;Fabbricazione di tulle, pizzi e merletti;Micro;2;1;0;1;0;0
13992;Fabbricazione di tulle, pizzi e merletti;Piccola;1;42;42;0;1;0
13999;Fabbricazione di feltro e articoli tessili diversi;Micro;1;1;0;1;0;0
14110;Confezione di abbigliamento in pelle e similpelle;Micro;13;25;10;15;2;1
14110;Confezione di abbigliamento in pelle e similpelle;Piccola;1;10;9;1;0;0
14120;Confezione di camici, divise ed altri indumenti da lavoro;Micro;15;44;28;16;1;5
14120;Confezione di camici, divise ed altri indumenti da lavoro;Piccola;3;87;81;6;2;0
14131;Confezione in serie di abbigliamento esterno;Grande;2;646;646;0;19;10
14131;Confezione in serie di abbigliamento esterno;Media;4;383;382;1;7;0
14131;Confezione in serie di abbigliamento esterno;Micro;195;478;300;178;43;1
14131;Confezione in serie di abbigliamento esterno;Piccola;25;468;443;25;21;4
14132;Sartoria e confezione su misura di abbigliamento esterno;Grande;1;369;369;0;20;3
14132;Sartoria e confezione su misura di abbigliamento esterno;Micro;199;308;100;208;14;0
14132;Sartoria e confezione su misura di abbigliamento esterno;Piccola;5;91;86;5;11;0
14140;Confezione di camicie, T-shirt, corsetteria e altra biancheria intima;Grande;1;354;354;0;0;0
14140;Confezione di camicie, T-shirt, corsetteria e altra biancheria intima;Micro;54;155;96;59;6;0
14140;Confezione di camicie, T-shirt, corsetteria e altra biancheria intima;Piccola;6;88;85;3;5;1
14191;Confezioni varie e accessori per l'abbigliamento;Grande;1;424;424;0;35;0
14191;Confezioni varie e accessori per l'abbigliamento;Micro;151;296;159;137;10;0
14191;Confezioni varie e accessori per l'abbigliamento;Piccola;17;338;312;26;15;2
14192;Confezioni di abbigliamento sportivo o indumenti particolari;Micro;34;79;49;30;7;0
14192;Confezioni di abbigliamento sportivo o indumenti particolari;Piccola;4;70;65;5;7;0
14200;Confezione di articoli in pelliccia;Micro;84;164;57;107;2;0
14200;Confezione di articoli in pelliccia;Piccola;2;33;32;1;0;0
14310;Fabbricazione di articoli di calzetteria in maglia;Micro;7;30;26;4;1;1
14310;Fabbricazione di articoli di calzetteria in maglia;Piccola;3;55;52;3;4;2
14390;Fabbricazione di pullover, cardigan ed altri articoli simili a maglia;Micro;52;120;71;49;8;0
14390;Fabbricazione di pullover, cardigan ed altri articoli simili a maglia;Piccola;6;132;124;8;3;1
15110;Preparazione e concia del cuoio e pelle| preparazione e tintura di pellicce;Micro;8;29;19;10;1;0
15110;Preparazione e concia del cuoio e pelle| preparazione e tintura di pellicce;Piccola;2;39;36;3;5;1
15120;Fabbricazione di articoli da viaggio, borse e simili, pelletteria e selleria;Grande;1;294;294;0;22;71
15120;Fabbricazione di articoli da viaggio, borse e simili, pelletteria e selleria;Media;5;433;430;3;9;14
15120;Fabbricazione di articoli da viaggio, borse e simili, pelletteria e selleria;Micro;148;302;135;167;13;1
15120;Fabbricazione di articoli da viaggio, borse e simili, pelletteria e selleria;Piccola;9;163;155;8;12;2
15201;Fabbricazione di calzature;Micro;21;36;26;10;6;0
15201;Fabbricazione di calzature;Piccola;8;194;191;3;6;0
15202;Fabbricazione di parti in cuoio per calzature;Micro;11;40;30;10;2;0
15202;Fabbricazione di parti in cuoio per calzature;Piccola;1;22;19;3;3;0
16100;Taglio e piallatura del legno;Micro;61;103;37;66;5;0
16100;Taglio e piallatura del legno;Piccola;3;51;48;3;2;0
16210;Fabbricazione di fogli da impiallacciatura e di pannelli a base di legno;Micro;41;70;28;42;5;0
16210;Fabbricazione di fogli da impiallacciatura e di pannelli a base di legno;Piccola;2;45;43;2;7;0
16220;Fabbricazione di pavimenti in parquet assemblato;Micro;1;1;0;1;0;0
16231;Fabbricazione di porte e finestre in legno (escluse porte blindate);Media;1;69;67;2;3;0
16231;Fabbricazione di porte e finestre in legno (escluse porte blindate);Micro;75;184;85;99;3;0
16231;Fabbricazione di porte e finestre in legno (escluse porte blindate);Piccola;12;187;174;13;6;0
16232;Fabbricazione di altri elementi in legno e di falegnameria per l'edilizia;Micro;20;48;28;20;0;0
16232;Fabbricazione di altri elementi in legno e di falegnameria per l'edilizia;Piccola;1;25;23;2;0;0
16240;Fabbricazione di imballaggi in legno;Micro;17;60;46;14;1;1
16240;Fabbricazione di imballaggi in legno;Piccola;3;44;40;4;1;0
16291;Fabbricazione di prodotti vari in legno (esclusi i mobili);Micro;17;28;12;16;0;0
16291;Fabbricazione di prodotti vari in legno (esclusi i mobili);Piccola;1;29;29;0;0;4
16292;Fabbricazione dei prodotti della lavorazione del sughero;Piccola;2;36;31;5;0;0
16294;Laboratori di corniciai;Micro;76;105;8;97;0;0
17120;Fabbricazione di carta e cartone;Grande;2;1100;1099;1;6;9
17120;Fabbricazione di carta e cartone;Micro;9;5;2;3;4;0
17120;Fabbricazione di carta e cartone;Piccola;2;58;57;1;0;0
17210;Fabbricazione di carta e cartone ondulato e di imballaggi di carta e cartone (esclusi quelli in carta pressata);Grande;1;1282;1282;0;6;41
17210;Fabbricazione di carta e cartone ondulato e di imballaggi di carta e cartone (esclusi quelli in carta pressata);Media;1;90;90;0;0;0
17210;Fabbricazione di carta e cartone ondulato e di imballaggi di carta e cartone (esclusi quelli in carta pressata);Micro;20;45;28;17;4;0
17210;Fabbricazione di carta e cartone ondulato e di imballaggi di carta e cartone (esclusi quelli in carta pressata);Piccola;9;195;181;14;7;9
17220;Fabbricazione di prodotti igienico-sanitari e per uso domestico in carta e ovatta di cellulosa;Media;1;132;131;1;2;0
17220;Fabbricazione di prodotti igienico-sanitari e per uso domestico in carta e ovatta di cellulosa;Micro;2;1;0;1;0;0
17220;Fabbricazione di prodotti igienico-sanitari e per uso domestico in carta e ovatta di cellulosa;Piccola;2;31;29;2;2;0
17230;Fabbricazione di prodotti cartotecnici;Micro;48;176;119;57;7;0
17230;Fabbricazione di prodotti cartotecnici;Piccola;11;156;138;18;3;0
17240;Fabbricazione di carta da parati;Micro;1;0;0;0;0;0
17240;Fabbricazione di carta da parati;Piccola;1;14;14;0;1;0
17290;Fabbricazione di altri articoli di carta e cartone;Media;1;57;56;1;1;0
17290;Fabbricazione di altri articoli di carta e cartone;Micro;25;55;32;23;0;2
17290;Fabbricazione di altri articoli di carta e cartone;Piccola;7;144;141;3;9;2
18110;Stampa di giornali;Media;2;118;118;0;1;3
18110;Stampa di giornali;Micro;1;3;3;0;0;0
18110;Stampa di giornali;Piccola;2;38;37;1;0;0
18120;Altra stampa;Media;5;462;454;8;6;16
18120;Altra stampa;Micro;377;976;505;471;58;1
18120;Altra stampa;Piccola;60;1016;944;72;45;1
18130;Lavorazioni preliminari alla stampa e ai media;Media;2;114;110;4;6;0
18130;Lavorazioni preliminari alla stampa e ai media;Micro;202;428;224;204;82;0
18130;Lavorazioni preliminari alla stampa e ai media;Piccola;30;518;477;41;35;0
18140;Legatoria e servizi connessi;Media;1;51;51;0;0;0
18140;Legatoria e servizi connessi;Micro;69;155;85;70;1;0
18140;Legatoria e servizi connessi;Piccola;9;179;163;16;1;0
18200;Riproduzione di supporti registrati;Micro;39;80;52;28;9;0
18200;Riproduzione di supporti registrati;Piccola;4;104;102;2;1;9
19201;Raffinerie di petrolio;Grande;1;1270;1270;0;8;0
19202;Preparazione o miscelazione di derivati del petrolio (esclusa la petrolchimica);Media;2;337;336;1;17;15
19202;Preparazione o miscelazione di derivati del petrolio (esclusa la petrolchimica);Micro;2;6;4;2;0;0
19202;Preparazione o miscelazione di derivati del petrolio (esclusa la petrolchimica);Piccola;3;63;58;5;0;0
19203;Miscelazione di gas petroliferi liquefatti (GPL) e loro imbottigliamento;Grande;2;1447;1447;0;9;0
19204;Fabbricazione di emulsioni di bitume, di catrame e di leganti per uso stradale;Micro;3;2;0;2;0;0
19204;Fabbricazione di emulsioni di bitume, di catrame e di leganti per uso stradale;Piccola;1;25;23;2;3;0
20110;Fabbricazione di gas industriali;Grande;2;948;948;0;34;47
20110;Fabbricazione di gas industriali;Media;4;537;536;1;9;40
20110;Fabbricazione di gas industriali;Micro;5;7;6;1;0;0
20120;Fabbricazione di coloranti e pigmenti;Media;1;137;137;0;0;1
20120;Fabbricazione di coloranti e pigmenti;Micro;2;1;1;0;0;0
20120;Fabbricazione di coloranti e pigmenti;Piccola;1;14;14;0;4;0
20130;Fabbricazione di altri prodotti chimici di base inorganici;Media;3;313;312;1;2;3
20130;Fabbricazione di altri prodotti chimici di base inorganici;Micro;6;22;20;2;1;0
20130;Fabbricazione di altri prodotti chimici di base inorganici;Piccola;5;97;95;2;1;0
20140;Fabbricazione di altri prodotti chimici di base organici;Grande;2;941;941;0;0;0
20140;Fabbricazione di altri prodotti chimici di base organici;Media;2;226;226;0;3;0
20140;Fabbricazione di altri prodotti chimici di base organici;Micro;10;34;27;7;6;0
20140;Fabbricazione di altri prodotti chimici di base organici;Piccola;3;51;43;8;0;1
20150;Fabbricazione di fertilizzanti e composti azotati (esclusa la fabbricazione di compost);Media;1;53;53;0;2;0
20150;Fabbricazione di fertilizzanti e composti azotati (esclusa la fabbricazione di compost);Micro;1;2;1;1;1;0
20160;Fabbricazione di materie plastiche in forme primarie;Grande;2;633;633;0;10;9
20160;Fabbricazione di materie plastiche in forme primarie;Media;3;387;384;3;4;3
20160;Fabbricazione di materie plastiche in forme primarie;Micro;7;12;11;1;3;0
20160;Fabbricazione di materie plastiche in forme primarie;Piccola;15;323;309;14;17;14
20170;Fabbricazione di gomma sintetica in forme primarie;Media;1;66;66;0;1;0
20170;Fabbricazione di gomma sintetica in forme primarie;Micro;1;6;6;0;0;0
20200;Fabbricazione di agrofarmaci e di altri prodotti chimici per l'agricoltura (esclusi i concimi);Grande;1;276;276;0;0;0
20200;Fabbricazione di agrofarmaci e di altri prodotti chimici per l'agricoltura (esclusi i concimi);Media;1;243;243;0;5;0
20200;Fabbricazione di agrofarmaci e di altri prodotti chimici per l'agricoltura (esclusi i concimi);Micro;2;1;0;1;1;0
20200;Fabbricazione di agrofarmaci e di altri prodotti chimici per l'agricoltura (esclusi i concimi);Piccola;1;17;17;0;0;0
20300;Fabbricazione di pitture, vernici e smalti, inchiostri da stampa e adesivi sintetici (mastici);Grande;1;1207;1207;0;23;7
20300;Fabbricazione di pitture, vernici e smalti, inchiostri da stampa e adesivi sintetici (mastici);Media;3;336;334;2;4;16
20300;Fabbricazione di pitture, vernici e smalti, inchiostri da stampa e adesivi sintetici (mastici);Micro;16;58;47;11;7;0
20300;Fabbricazione di pitture, vernici e smalti, inchiostri da stampa e adesivi sintetici (mastici);Piccola;13;265;252;13;14;1
20411;Fabbricazione di saponi, detergenti e di agenti organici tensioattivi (esclusi i prodotti per toletta);Grande;3;3227;3227;0;14;271
20411;Fabbricazione di saponi, detergenti e di agenti organici tensioattivi (esclusi i prodotti per toletta);Media;3;321;321;0;0;6
20411;Fabbricazione di saponi, detergenti e di agenti organici tensioattivi (esclusi i prodotti per toletta);Micro;9;25;21;4;4;0
20411;Fabbricazione di saponi, detergenti e di agenti organici tensioattivi (esclusi i prodotti per toletta);Piccola;1;49;47;2;4;0
20412;Fabbricazione di specialità chimiche per uso domestico e per manutenzione;Micro;1;4;2;2;0;0
20412;Fabbricazione di specialità chimiche per uso domestico e per manutenzione;Piccola;2;55;52;3;6;0
20420;Fabbricazione di prodotti per toletta: profumi, cosmetici, saponi e simili;Media;5;612;610;2;33;10
20420;Fabbricazione di prodotti per toletta: profumi, cosmetici, saponi e simili;Micro;55;140;100;40;13;0
20420;Fabbricazione di prodotti per toletta: profumi, cosmetici, saponi e simili;Piccola;24;482;455;27;27;3
20520;Fabbricazione di colle;Media;1;61;59;2;2;14
20520;Fabbricazione di colle;Micro;1;4;2;2;0;0
20520;Fabbricazione di colle;Piccola;3;88;85;3;3;0
20530;Fabbricazione di oli essenziali;Micro;3;5;4;1;1;0
20530;Fabbricazione di oli essenziali;Piccola;6;115;111;4;8;2
20591;Fabbricazione di prodotti chimici per uso fotografico;Micro;1;5;3;2;0;0
20592;Fabbricazione di prodotti chimici organici ottenuti da prodotti di base derivati da processi di fermentazione o da materie prime vegetali;Micro;9;15;9;6;9;0
20592;Fabbricazione di prodotti chimici organici ottenuti da prodotti di base derivati da processi di fermentazione o da materie prime vegetali;Piccola;3;51;48;3;7;0
20593;Trattamento chimico degli acidi grassi;Media;1;75;75;0;1;1
20593;Trattamento chimico degli acidi grassi;Micro;1;7;7;0;0;0
20593;Trattamento chimico degli acidi grassi;Piccola;1;25;23;2;3;16
20594;Fabbricazione di prodotti chimici vari per uso industriale (inclusi i preparati antidetonanti e antigelo);Media;2;180;180;0;8;0
20594;Fabbricazione di prodotti chimici vari per uso industriale (inclusi i preparati antidetonanti e antigelo);Micro;29;58;51;7;6;2
20594;Fabbricazione di prodotti chimici vari per uso industriale (inclusi i preparati antidetonanti e antigelo);Piccola;19;426;409;17;26;9
20595;Fabbricazione di prodotti chimici impiegati per ufficio e per il consumo non industriale;Micro;2;10;7;3;0;0
20595;Fabbricazione di prodotti chimici impiegati per ufficio e per il consumo non industriale;Piccola;1;43;43;0;0;0
20596;Fabbricazione di prodotti ausiliari per le industrie tessili e del cuoio;Micro;5;17;15;2;3;0
20596;Fabbricazione di prodotti ausiliari per le industrie tessili e del cuoio;Piccola;5;123;122;1;9;0
20597;Fabbricazione di prodotti elettrochimici (esclusa produzione di cloro, soda e potassa) ed elettrotermici;Media;1;145;145;0;8;0
20597;Fabbricazione di prodotti elettrochimici (esclusa produzione di cloro, soda e potassa) ed elettrotermici;Piccola;1;27;27;0;1;0
20599;Fabbricazione di altri prodotti chimici nca;Micro;4;16;14;2;0;0
20599;Fabbricazione di altri prodotti chimici nca;Piccola;1;13;13;0;1;0
20600;Fabbricazione di fibre sintetiche e artificiali;Media;3;373;371;2;8;2
20600;Fabbricazione di fibre sintetiche e artificiali;Micro;3;23;20;3;0;0
20600;Fabbricazione di fibre sintetiche e artificiali;Piccola;1;19;18;1;0;0
21100;Fabbricazione di prodotti farmaceutici di base;Grande;2;723;723;0;13;9
21100;Fabbricazione di prodotti farmaceutici di base;Media;2;139;139;0;5;1
21100;Fabbricazione di prodotti farmaceutici di base;Micro;7;6;4;2;0;0
21100;Fabbricazione di prodotti farmaceutici di base;Piccola;5;115;111;4;3;0
21200;Fabbricazione di medicinali e preparati farmaceutici;Grande;5;4998;4998;0;43;38
21200;Fabbricazione di medicinali e preparati farmaceutici;Media;15;2109;2099;10;49;27
21200;Fabbricazione di medicinali e preparati farmaceutici;Micro;36;64;53;11;15;0
21200;Fabbricazione di medicinali e preparati farmaceutici;Piccola;20;538;529;9;36;16
22111;Fabbricazione di pneumatici e di camere d'aria;Grande;1;1933;1933;0;14;9
22190;Fabbricazione di altri prodotti in gomma;Media;2;299;299;0;2;8
22190;Fabbricazione di altri prodotti in gomma;Micro;15;38;26;12;1;1
22190;Fabbricazione di altri prodotti in gomma;Piccola;15;339;320;19;7;4
22210;Fabbricazione di lastre, fogli, tubi e profilati in materie plastiche;Media;2;111;110;1;0;0
22210;Fabbricazione di lastre, fogli, tubi e profilati in materie plastiche;Micro;15;47;41;6;8;0
22210;Fabbricazione di lastre, fogli, tubi e profilati in materie plastiche;Piccola;15;326;315;11;11;9
22220;Fabbricazione di imballaggi in materie plastiche;Media;1;64;64;0;0;0
22220;Fabbricazione di imballaggi in materie plastiche;Micro;23;64;46;18;2;0
22220;Fabbricazione di imballaggi in materie plastiche;Piccola;18;442;429;13;18;1
22230;Fabbricazione di articoli in plastica per l'edilizia;Micro;11;35;27;8;3;0
22230;Fabbricazione di articoli in plastica per l'edilizia;Piccola;5;143;138;5;4;0
22290;Fabbricazione di altri articoli in materie plastiche;Grande;1;293;293;0;4;0
22290;Fabbricazione di altri articoli in materie plastiche;Media;3;437;432;5;9;15
22290;Fabbricazione di altri articoli in materie plastiche;Micro;106;273;170;103;15;3
22290;Fabbricazione di altri articoli in materie plastiche;Piccola;50;1082;1022;60;44;51
23120;Lavorazione e trasformazione del vetro piano;Micro;22;58;30;28;0;0
23120;Lavorazione e trasformazione del vetro piano;Piccola;6;95;84;11;0;0
23130;Fabbricazione di vetro cavo;Micro;2;0;0;0;0;0
23130;Fabbricazione di vetro cavo;Piccola;2;44;43;1;2;0
23140;Fabbricazione di fibre di vetro;Micro;1;1;1;0;0;0
23140;Fabbricazione di fibre di vetro;Piccola;1;27;27;0;1;0
23192;Lavorazione di vetro a mano e a soffio artistico;Micro;10;21;10;11;1;0
23192;Lavorazione di vetro a mano e a soffio artistico;Piccola;1;41;41;0;2;0
23199;Fabbricazione di altri prodotti in vetro (inclusa la vetreria tecnica);Micro;3;9;5;4;0;0
23199;Fabbricazione di altri prodotti in vetro (inclusa la vetreria tecnica);Piccola;2;53;46;7;2;0
23200;Fabbricazione di prodotti refrattari;Media;1;160;160;0;5;1
23200;Fabbricazione di prodotti refrattari;Micro;1;0;0;0;0;0
23200;Fabbricazione di prodotti refrattari;Piccola;4;86;82;4;2;0
23320;Fabbricazione di mattoni, tegole ed altri prodotti per l'edilizia in terracotta;Media;1;56;56;0;0;0
23320;Fabbricazione di mattoni, tegole ed altri prodotti per l'edilizia in terracotta;Micro;1;0;0;0;0;0
23410;Fabbricazione di prodotti in ceramica per usi domestici e ornamentali;Micro;15;28;13;15;3;0
23420;Fabbricazione di articoli sanitari in ceramica;Grande;1;1391;1391;0;1;0
23420;Fabbricazione di articoli sanitari in ceramica;Micro;3;5;0;5;0;0
23430;Fabbricazione di isolatori e di pezzi isolanti in ceramica;Piccola;1;13;12;1;0;0
23440;Fabbricazione di altri prodotti in ceramica per uso tecnico e industriale;Micro;1;0;0;0;0;0
23440;Fabbricazione di altri prodotti in ceramica per uso tecnico e industriale;Piccola;1;12;12;0;0;0
23490;Fabbricazione di altri prodotti in ceramica;Micro;3;6;3;3;0;0
23490;Fabbricazione di altri prodotti in ceramica;Piccola;1;11;10;1;0;0
23510;Produzione di cemento;Micro;3;1;0;1;2;0
23510;Produzione di cemento;Piccola;1;12;12;0;0;0
23610;Fabbricazione di prodotti in calcestruzzo per l'edilizia;Micro;13;29;16;13;0;0
23610;Fabbricazione di prodotti in calcestruzzo per l'edilizia;Piccola;3;61;61;0;4;0
23620;Fabbricazione di prodotti in gesso per l'edilizia;Grande;1;728;728;0;12;20
23620;Fabbricazione di prodotti in gesso per l'edilizia;Media;1;137;137;0;0;2
23620;Fabbricazione di prodotti in gesso per l'edilizia;Micro;3;8;1;7;0;0
23630;Produzione di calcestruzzo pronto per l'uso;Micro;2;6;6;0;0;0
23630;Produzione di calcestruzzo pronto per l'uso;Piccola;3;57;55;2;3;0
23640;Produzione di malta;Micro;1;4;4;0;0;0
23650;Fabbricazione di prodotti in fibrocemento;Media;1;120;117;3;2;5
23690;Fabbricazione di altri prodotti in calcestruzzo, gesso e cemento;Micro;3;6;3;3;0;0
23690;Fabbricazione di altri prodotti in calcestruzzo, gesso e cemento;Piccola;1;43;43;0;0;0
23701;Segagione e lavorazione delle pietre e del marmo;Micro;17;47;35;12;2;0
23701;Segagione e lavorazione delle pietre e del marmo;Piccola;6;105;100;5;4;0
23702;Lavorazione artistica del marmo e di altre pietre affini, lavori in mosaico;Micro;30;62;30;32;5;0
23702;Lavorazione artistica del marmo e di altre pietre affini, lavori in mosaico;Piccola;1;11;8;3;0;0
23703;Frantumazione di pietre e minerali vari non in connessione con l'estrazione;Micro;3;9;9;0;0;0
23910;Produzione di prodotti abrasivi;Micro;7;29;20;9;1;0
23910;Produzione di prodotti abrasivi;Piccola;6;99;92;7;3;0
23990;Fabbricazione di altri prodotti in minerali non metalliferi nca;Media;2;174;174;0;7;0
23990;Fabbricazione di altri prodotti in minerali non metalliferi nca;Micro;11;35;23;12;2;0
23990;Fabbricazione di altri prodotti in minerali non metalliferi nca;Piccola;3;39;35;4;0;1
24100;Siderurgia - Fabbricazione di ferro, acciaio e ferroleghe;Grande;1;1377;1377;0;2;2
24100;Siderurgia - Fabbricazione di ferro, acciaio e ferroleghe;Micro;17;42;28;14;5;0
24100;Siderurgia - Fabbricazione di ferro, acciaio e ferroleghe;Piccola;5;79;74;5;1;0
24201;Fabbricazione di tubi e condotti senza saldatura;Micro;2;0;0;0;0;0
24201;Fabbricazione di tubi e condotti senza saldatura;Piccola;1;11;10;1;0;2
24202;Fabbricazione di tubi e condotti saldati e simili;Micro;1;2;1;1;0;0
24202;Fabbricazione di tubi e condotti saldati e simili;Piccola;5;119;115;4;2;1
24320;Laminazione a freddo di nastri;Media;1;66;66;0;2;1
24320;Laminazione a freddo di nastri;Micro;1;0;0;0;0;0
24320;Laminazione a freddo di nastri;Piccola;5;188;184;4;12;15
24330;Profilatura mediante formatura o piegatura a freddo| fabbricazione di pannelli stratificati in acciaio;Media;1;161;161;0;0;0
24330;Profilatura mediante formatura o piegatura a freddo| fabbricazione di pannelli stratificati in acciaio;Micro;2;8;7;1;2;0
24330;Profilatura mediante formatura o piegatura a freddo| fabbricazione di pannelli stratificati in acciaio;Piccola;5;73;65;8;0;1
24340;Trafilatura a freddo;Micro;3;13;9;4;1;0
24340;Trafilatura a freddo;Piccola;3;72;71;1;3;0
24410;Produzione di metalli preziosi e semilavorati;Micro;12;40;22;18;0;0
24410;Produzione di metalli preziosi e semilavorati;Piccola;1;10;9;1;0;0
24420;Produzione di alluminio e semilavorati;Media;2;222;222;0;5;2
24420;Produzione di alluminio e semilavorati;Micro;15;23;9;14;0;0
24420;Produzione di alluminio e semilavorati;Piccola;5;183;177;6;5;1
24430;Produzione di piombo, zinco e stagno e semilavorati;Media;1;79;79;0;5;2
24430;Produzione di piombo, zinco e stagno e semilavorati;Piccola;1;16;15;1;0;0
24440;Produzione di rame e semilavorati;Grande;1;273;273;0;2;1
24440;Produzione di rame e semilavorati;Micro;3;8;6;2;0;0
24440;Produzione di rame e semilavorati;Piccola;1;35;33;2;2;0
24450;Produzione di altri metalli non ferrosi e semilavorati;Micro;2;8;6;2;0;0
24450;Produzione di altri metalli non ferrosi e semilavorati;Piccola;1;13;12;1;0;0
24510;Fusione di ghisa e produzione di tubi e raccordi in ghisa;Media;1;52;52;0;2;0
24510;Fusione di ghisa e produzione di tubi e raccordi in ghisa;Micro;2;4;4;0;0;0
24510;Fusione di ghisa e produzione di tubi e raccordi in ghisa;Piccola;3;48;48;0;3;1
24520;Fusione di acciaio;Micro;1;2;1;1;0;0
24530;Fusione di metalli leggeri;Micro;8;37;33;4;1;2
24530;Fusione di metalli leggeri;Piccola;9;137;127;10;2;0
24540;Fusione di altri metalli non ferrosi;Micro;8;34;21;13;4;1
24540;Fusione di altri metalli non ferrosi;Piccola;4;90;88;2;2;0
25110;Fabbricazione di strutture metalliche e parti assemblate di strutture;Grande;1;601;601;0;0;1
25110;Fabbricazione di strutture metalliche e parti assemblate di strutture;Media;1;148;148;0;1;0
25110;Fabbricazione di strutture metalliche e parti assemblate di strutture;Micro;100;296;219;77;15;0
25110;Fabbricazione di strutture metalliche e parti assemblate di strutture;Piccola;52;992;947;45;22;9
25121;Fabbricazione di porte, finestre e loro telai, imposte e cancelli metallici;Micro;86;288;179;109;5;0
25121;Fabbricazione di porte, finestre e loro telai, imposte e cancelli metallici;Piccola;18;293;269;24;12;0
25122;Fabbricazione di strutture metalliche per tende da sole, tende alla veneziana e simili;Micro;24;56;29;27;1;0
25122;Fabbricazione di strutture metalliche per tende da sole, tende alla veneziana e simili;Piccola;1;11;11;0;1;0
25210;Fabbricazione di radiatori e contenitori in metallo per caldaie per il riscaldamento centrale;Micro;3;5;3;2;0;0
25210;Fabbricazione di radiatori e contenitori in metallo per caldaie per il riscaldamento centrale;Piccola;2;55;50;5;0;0
25290;Fabbricazione di cisterne, serbatoi e contenitori in metallo per impieghi di stoccaggio o di produzione;Micro;6;19;14;5;0;0
25290;Fabbricazione di cisterne, serbatoi e contenitori in metallo per impieghi di stoccaggio o di produzione;Piccola;2;50;46;4;0;0
25300;Fabbricazione di generatori di vapore (esclusi i contenitori in metallo per caldaie per il riscaldamento centrale ad acqua calda);Media;1;96;96;0;2;0
25300;Fabbricazione di generatori di vapore (esclusi i contenitori in metallo per caldaie per il riscaldamento centrale ad acqua calda);Micro;5;19;14;5;1;0
25300;Fabbricazione di generatori di vapore (esclusi i contenitori in metallo per caldaie per il riscaldamento centrale ad acqua calda);Piccola;5;92;89;3;2;0
25400;Fabbricazione di armi e munizioni;Micro;2;2;1;1;0;0
25400;Fabbricazione di armi e munizioni;Piccola;1;17;17;0;0;1
25500;Fucinatura, imbutitura, stampaggio e profilatura dei metalli| metallurgia delle polveri;Media;2;339;339;0;4;1
25500;Fucinatura, imbutitura, stampaggio e profilatura dei metalli| metallurgia delle polveri;Micro;22;82;55;27;1;0
25500;Fucinatura, imbutitura, stampaggio e profilatura dei metalli| metallurgia delle polveri;Piccola;11;218;209;9;10;2
25610;Trattamento e rivestimento dei metalli;Micro;51;167;105;62;5;0
25610;Trattamento e rivestimento dei metalli;Piccola;17;307;287;20;3;5
25620;Lavori di meccanica generale;Media;1;117;115;2;0;0
25620;Lavori di meccanica generale;Micro;140;403;277;126;17;3
25620;Lavori di meccanica generale;Piccola;53;1029;972;57;32;13
25710;Fabbricazione di articoli di coltelleria, posateria ed armi bianche;Micro;5;13;9;4;1;0
25710;Fabbricazione di articoli di coltelleria, posateria ed armi bianche;Piccola;1;40;38;2;1;0
25720;Fabbricazione di serrature e cerniere e ferramenta simili;Micro;1;0;0;0;0;0
25720;Fabbricazione di serrature e cerniere e ferramenta simili;Piccola;2;94;89;5;2;9
25731;Fabbricazione di utensileria ad azionamento manuale| parti intercambiabili per macchine utensili;Micro;29;71;45;26;2;0
25731;Fabbricazione di utensileria ad azionamento manuale| parti intercambiabili per macchine utensili;Piccola;15;301;285;16;8;5
25732;Fabbricazione di stampi, portastampi, sagome, forme per macchine;Micro;24;81;56;25;5;1
25732;Fabbricazione di stampi, portastampi, sagome, forme per macchine;Piccola;7;106;102;4;5;1
25910;Fabbricazione di bidoni in acciaio e contenitori analoghi per il trasporto e l'imballaggio;Micro;1;5;4;1;1;0
25910;Fabbricazione di bidoni in acciaio e contenitori analoghi per il trasporto e l'imballaggio;Piccola;2;30;27;3;2;0
25920;Fabbricazione di imballaggi leggeri in metallo;Micro;3;1;0;1;0;0
25920;Fabbricazione di imballaggi leggeri in metallo;Piccola;3;56;56;0;5;0
25931;Fabbricazione di prodotti fabbricati con fili metallici;Media;1;220;219;1;6;4
25931;Fabbricazione di prodotti fabbricati con fili metallici;Micro;15;49;41;8;2;0
25931;Fabbricazione di prodotti fabbricati con fili metallici;Piccola;4;57;52;5;4;0
25932;Fabbricazione di molle;Micro;6;26;24;2;1;0
25932;Fabbricazione di molle;Piccola;3;53;48;5;0;0
25933;Fabbricazione di catene fucinate senza saldatura e stampate;Micro;1;1;1;0;0;0
25940;Fabbricazione di articoli di bulloneria;Media;2;171;171;0;3;0
25940;Fabbricazione di articoli di bulloneria;Micro;4;16;14;2;1;0
25940;Fabbricazione di articoli di bulloneria;Piccola;6;150;142;8;4;7
25991;Fabbricazione di stoviglie, pentolame, vasellame, attrezzi da cucina e accessori casalinghi non elettrici, articoli metallici per l'arredamento di stanze da bagno;Micro;8;22;17;5;5;1
25991;Fabbricazione di stoviglie, pentolame, vasellame, attrezzi da cucina e accessori casalinghi non elettrici, articoli metallici per l'arredamento di stanze da bagno;Piccola;3;42;42;0;28;0
25992;Fabbricazione di casseforti, forzieri e porte metalliche blindate;Micro;7;14;6;8;0;0
25993;Fabbricazione di oggetti in ferro, in rame ed altri metalli;Micro;66;123;44;79;5;0
25993;Fabbricazione di oggetti in ferro, in rame ed altri metalli;Piccola;5;65;60;5;8;3
25999;Fabbricazione di altri articoli metallici e minuteria metallica;Media;2;238;236;2;3;0
25999;Fabbricazione di altri articoli metallici e minuteria metallica;Micro;72;200;126;74;7;0
25999;Fabbricazione di altri articoli metallici e minuteria metallica;Piccola;24;529;500;29;25;18
26110;Fabbricazione di componenti elettronici;Micro;30;72;57;15;5;0
26110;Fabbricazione di componenti elettronici;Piccola;8;175;158;17;6;0
26120;Fabbricazione di schede elettroniche assemblate;Micro;21;50;25;25;1;0
26120;Fabbricazione di schede elettroniche assemblate;Piccola;8;142;134;8;7;29
26200;Fabbricazione di computer e unità periferiche;Media;1;56;56;0;0;1
26200;Fabbricazione di computer e unità periferiche;Micro;17;30;17;13;1;0
26200;Fabbricazione di computer e unità periferiche;Piccola;2;39;37;2;2;0
26301;Fabbricazione di apparecchi trasmittenti radiotelevisivi (incluse le telecamere);Micro;7;30;23;7;3;0
26301;Fabbricazione di apparecchi trasmittenti radiotelevisivi (incluse le telecamere);Piccola;1;24;24;0;4;0
26302;Fabbricazione di apparecchi elettrici ed elettronici per telecomunicazioni;Grande;1;653;653;0;0;0
26302;Fabbricazione di apparecchi elettrici ed elettronici per telecomunicazioni;Media;4;476;475;1;26;1
26302;Fabbricazione di apparecchi elettrici ed elettronici per telecomunicazioni;Micro;36;91;77;14;11;1
26302;Fabbricazione di apparecchi elettrici ed elettronici per telecomunicazioni;Piccola;15;356;336;20;8;0
26400;Fabbricazione di apparecchi per la riproduzione e registrazione del suono e delle immagini;Media;1;202;202;0;1;0
26400;Fabbricazione di apparecchi per la riproduzione e registrazione del suono e delle immagini;Micro;6;20;18;2;2;0
26400;Fabbricazione di apparecchi per la riproduzione e registrazione del suono e delle immagini;Piccola;1;13;13;0;2;0
26511;Fabbricazione di strumenti per navigazione, idrologia, geofisica e meteorologia;Micro;7;18;16;2;4;0
26512;Fabbricazione di contatori di elettricità, gas, acqua ed altri liquidi, di bilance analitiche di precisione, di apparecchi di misura e regolazione (incluse parti staccate e accessori);Media;2;148;146;2;7;0
26512;Fabbricazione di contatori di elettricità, gas, acqua ed altri liquidi, di bilance analitiche di precisione, di apparecchi di misura e regolazione (incluse parti staccate e accessori);Micro;35;88;56;32;9;0
26512;Fabbricazione di contatori di elettricità, gas, acqua ed altri liquidi, di bilance analitiche di precisione, di apparecchi di misura e regolazione (incluse parti staccate e accessori);Piccola;20;429;406;23;16;9
26520;Fabbricazione di orologi;Micro;5;14;6;8;2;0
26520;Fabbricazione di orologi;Piccola;1;17;16;1;0;0
26600;Fabbricazione di strumenti per irradiazione, apparecchiature elettromedicali ed elettroterapeutiche;Grande;2;1196;1196;0;4;19
26600;Fabbricazione di strumenti per irradiazione, apparecchiature elettromedicali ed elettroterapeutiche;Media;5;655;655;0;5;4
26600;Fabbricazione di strumenti per irradiazione, apparecchiature elettromedicali ed elettroterapeutiche;Micro;29;55;44;11;5;0
26600;Fabbricazione di strumenti per irradiazione, apparecchiature elettromedicali ed elettroterapeutiche;Piccola;7;123;114;9;6;0
26701;Fabbricazione di elementi ottici e strumenti ottici di misura, controllo e precisione;Micro;4;16;15;1;1;0
26701;Fabbricazione di elementi ottici e strumenti ottici di misura, controllo e precisione;Piccola;1;16;16;0;0;1
26702;Fabbricazione di apparecchiature fotografiche e cinematografiche;Media;1;85;84;1;2;0
26702;Fabbricazione di apparecchiature fotografiche e cinematografiche;Micro;1;3;1;2;1;0
26702;Fabbricazione di apparecchiature fotografiche e cinematografiche;Piccola;1;15;14;1;1;0
26800;Fabbricazione di supporti magnetici ed ottici;Micro;2;2;0;2;0;0
26800;Fabbricazione di supporti magnetici ed ottici;Piccola;1;15;14;1;0;0
27110;Fabbricazione di motori, generatori e trasformatori elettrici;Grande;1;1000;1000;0;25;7
27110;Fabbricazione di motori, generatori e trasformatori elettrici;Media;2;169;169;0;15;2
27110;Fabbricazione di motori, generatori e trasformatori elettrici;Micro;38;109;76;33;9;0
27110;Fabbricazione di motori, generatori e trasformatori elettrici;Piccola;11;203;195;8;8;2
27120;Fabbricazione di apparecchiature per le reti di distribuzione e il controllo dell'elettricità;Grande;1;2939;2939;0;5;70
27120;Fabbricazione di apparecchiature per le reti di distribuzione e il controllo dell'elettricità;Media;1;119;117;2;2;0
27120;Fabbricazione di apparecchiature per le reti di distribuzione e il controllo dell'elettricità;Micro;35;114;84;30;6;0
27120;Fabbricazione di apparecchiature per le reti di distribuzione e il controllo dell'elettricità;Piccola;13;284;270;14;11;3
27200;Fabbricazione di batterie di pile ed accumulatori elettrici;Micro;1;7;7;0;1;0
27310;Fabbricazione di cavi a fibra ottica;Grande;1;298;298;0;11;7
27310;Fabbricazione di cavi a fibra ottica;Micro;1;0;0;0;0;0
27320;Fabbricazione di altri fili e cavi elettrici ed elettronici;Grande;2;1493;1493;0;17;118
27320;Fabbricazione di altri fili e cavi elettrici ed elettronici;Micro;3;23;20;3;1;0
27320;Fabbricazione di altri fili e cavi elettrici ed elettronici;Piccola;2;77;76;1;1;1
27330;Fabbricazione di attrezzature per cablaggio;Micro;8;27;20;7;1;0
27330;Fabbricazione di attrezzature per cablaggio;Piccola;6;101;94;7;3;3
27400;Fabbricazione di apparecchiature per illuminazione;Grande;1;1041;1041;0;1;51
27400;Fabbricazione di apparecchiature per illuminazione;Media;3;178;176;2;4;3
27400;Fabbricazione di apparecchiature per illuminazione;Micro;54;130;77;53;13;0
27400;Fabbricazione di apparecchiature per illuminazione;Piccola;10;189;178;11;11;0
27510;Fabbricazione di elettrodomestici;Media;1;65;64;1;2;0
27510;Fabbricazione di elettrodomestici;Micro;7;6;1;5;0;0
27510;Fabbricazione di elettrodomestici;Piccola;4;93;90;3;1;0
27520;Fabbricazione di apparecchi per uso domestico non elettrici;Micro;3;0;0;0;2;0
27900;Fabbricazione di altre apparecchiature elettriche;Media;5;517;511;6;13;2
27900;Fabbricazione di altre apparecchiature elettriche;Micro;82;230;158;72;19;0
27900;Fabbricazione di altre apparecchiature elettriche;Piccola;24;435;395;40;15;17
28112;Fabbricazione di turbine e turboalternatori (incluse parti e accessori);Media;1;54;54;0;1;0
28112;Fabbricazione di turbine e turboalternatori (incluse parti e accessori);Micro;7;23;22;1;2;0
28112;Fabbricazione di turbine e turboalternatori (incluse parti e accessori);Piccola;1;25;22;3;0;0
28120;Fabbricazione di apparecchiature fluidodinamiche;Grande;1;294;294;0;1;8
28120;Fabbricazione di apparecchiature fluidodinamiche;Media;2;233;229;4;13;5
28120;Fabbricazione di apparecchiature fluidodinamiche;Micro;2;12;10;2;1;0
28120;Fabbricazione di apparecchiature fluidodinamiche;Piccola;2;44;42;2;1;0
28130;Fabbricazione di altre pompe e compressori;Media;1;61;59;2;0;0
28130;Fabbricazione di altre pompe e compressori;Micro;8;14;6;8;0;0
28130;Fabbricazione di altre pompe e compressori;Piccola;6;126;121;5;7;0
28140;Fabbricazione di altri rubinetti e valvole;Grande;1;378;378;0;2;1
28140;Fabbricazione di altri rubinetti e valvole;Media;2;133;131;2;3;2
28140;Fabbricazione di altri rubinetti e valvole;Micro;18;67;58;9;4;0
28140;Fabbricazione di altri rubinetti e valvole;Piccola;11;205;193;12;9;0
28151;Fabbricazione di organi di trasmissione (esclusi quelli idraulici e quelli per autoveicoli, aeromobili e motocicli);Grande;1;860;858;2;1;91
28151;Fabbricazione di organi di trasmissione (esclusi quelli idraulici e quelli per autoveicoli, aeromobili e motocicli);Micro;9;17;13;4;1;0
28151;Fabbricazione di organi di trasmissione (esclusi quelli idraulici e quelli per autoveicoli, aeromobili e motocicli);Piccola;7;113;110;3;10;0
28152;Fabbricazione di cuscinetti a sfere;Micro;1;3;1;2;0;0
28211;Fabbricazione di forni, fornaci e bruciatori;Micro;14;23;15;8;4;0
28211;Fabbricazione di forni, fornaci e bruciatori;Piccola;5;116;111;5;17;2
28212;Fabbricazione di sistemi di riscaldamento;Micro;4;18;17;1;1;0
28212;Fabbricazione di sistemi di riscaldamento;Piccola;1;12;12;0;0;0
28220;Fabbricazione di macchine e apparecchi di sollevamento e movimentazione;Grande;1;281;281;0;13;16
28220;Fabbricazione di macchine e apparecchi di sollevamento e movimentazione;Media;2;144;143;1;6;2
28220;Fabbricazione di macchine e apparecchi di sollevamento e movimentazione;Micro;27;61;49;12;4;0
28220;Fabbricazione di macchine e apparecchi di sollevamento e movimentazione;Piccola;16;422;413;9;12;4
28230;Fabbricazione di macchine ed attrezzature per ufficio (esclusi computer e unità periferiche);Micro;9;29;17;12;0;0
28230;Fabbricazione di macchine ed attrezzature per ufficio (esclusi computer e unità periferiche);Piccola;1;24;23;1;0;0
28240;Fabbricazione di utensili portatili a motore;Media;2;105;102;3;2;1
28240;Fabbricazione di utensili portatili a motore;Micro;1;3;0;3;0;0
28250;Fabbricazione di attrezzature di uso non domestico per la refrigerazione e la ventilazione| fabbricazione di condizionatori domestici fissi;Media;2;246;245;1;0;0
28250;Fabbricazione di attrezzature di uso non domestico per la refrigerazione e la ventilazione| fabbricazione di condizionatori domestici fissi;Micro;28;58;44;14;1;0
28250;Fabbricazione di attrezzature di uso non domestico per la refrigerazione e la ventilazione| fabbricazione di condizionatori domestici fissi;Piccola;16;294;284;10;22;21
28291;Fabbricazione di bilance e di macchine automatiche per la vendita e la distribuzione (incluse parti staccate e accessori);Micro;2;1;0;1;0;0
28291;Fabbricazione di bilance e di macchine automatiche per la vendita e la distribuzione (incluse parti staccate e accessori);Piccola;5;153;144;9;6;2
28292;Fabbricazione di macchine e apparecchi per le industrie chimiche, petrolchimiche e petrolifere (incluse parti e accessori);Media;5;750;748;2;43;6
28292;Fabbricazione di macchine e apparecchi per le industrie chimiche, petrolchimiche e petrolifere (incluse parti e accessori);Micro;28;80;65;15;21;0
28292;Fabbricazione di macchine e apparecchi per le industrie chimiche, petrolchimiche e petrolifere (incluse parti e accessori);Piccola;19;397;370;27;29;19
28293;Fabbricazione di macchine automatiche per la dosatura, la confezione e per l'imballaggio (incluse parti e accessori);Media;2;179;178;1;1;3
28293;Fabbricazione di macchine automatiche per la dosatura, la confezione e per l'imballaggio (incluse parti e accessori);Micro;17;38;31;7;5;0
28293;Fabbricazione di macchine automatiche per la dosatura, la confezione e per l'imballaggio (incluse parti e accessori);Piccola;8;158;146;12;5;2
28299;Fabbricazione di macchine di impiego generale ed altro materiale meccanico nca;Media;4;230;225;5;8;7
28299;Fabbricazione di macchine di impiego generale ed altro materiale meccanico nca;Micro;48;120;93;27;11;1
28299;Fabbricazione di macchine di impiego generale ed altro materiale meccanico nca;Piccola;26;559;531;28;24;15
28309;Fabbricazione di altre macchine per l'agricoltura, la silvicoltura e la zootecnia;Micro;4;8;6;2;0;0
28309;Fabbricazione di altre macchine per l'agricoltura, la silvicoltura e la zootecnia;Piccola;2;36;36;0;0;1
28410;Fabbricazione di macchine utensili per la formatura dei metalli (incluse parti e accessori ed escluse le parti intercambiabili);Media;2;118;118;0;1;0
28410;Fabbricazione di macchine utensili per la formatura dei metalli (incluse parti e accessori ed escluse le parti intercambiabili);Micro;8;7;6;1;0;0
28410;Fabbricazione di macchine utensili per la formatura dei metalli (incluse parti e accessori ed escluse le parti intercambiabili);Piccola;4;81;77;4;3;0
28490;Fabbricazione di altre macchine utensili (incluse parti e accessori);Media;1;54;54;0;0;0
28490;Fabbricazione di altre macchine utensili (incluse parti e accessori);Micro;26;68;56;12;7;0
28490;Fabbricazione di altre macchine utensili (incluse parti e accessori);Piccola;8;122;117;5;10;0
28910;Fabbricazione di macchine per la metallurgia (incluse parti e accessori);Grande;1;619;619;0;40;8
28910;Fabbricazione di macchine per la metallurgia (incluse parti e accessori);Micro;27;64;45;19;3;1
28910;Fabbricazione di macchine per la metallurgia (incluse parti e accessori);Piccola;13;245;228;17;17;6
28920;Fabbricazione di macchine da miniera, cava e cantiere (incluse parti e accessori);Micro;13;34;24;10;0;0
28920;Fabbricazione di macchine da miniera, cava e cantiere (incluse parti e accessori);Piccola;10;192;186;6;24;1
28930;Fabbricazione di macchine per l'industria alimentare, delle bevande e del tabacco (incluse parti e accessori);Grande;1;1362;1362;0;31;9
28930;Fabbricazione di macchine per l'industria alimentare, delle bevande e del tabacco (incluse parti e accessori);Micro;27;98;77;21;7;1
28930;Fabbricazione di macchine per l'industria alimentare, delle bevande e del tabacco (incluse parti e accessori);Piccola;14;252;236;16;11;3
28941;Fabbricazione di macchine tessili, di macchine e di impianti per il trattamento ausiliario dei tessili, di macchine per cucire e per maglieria (incluse parti e accessori);Micro;18;55;41;14;6;0
28941;Fabbricazione di macchine tessili, di macchine e di impianti per il trattamento ausiliario dei tessili, di macchine per cucire e per maglieria (incluse parti e accessori);Piccola;4;101;101;0;3;1
28942;Fabbricazione di macchine e apparecchi per l'industria delle pelli, del cuoio e delle calzature (incluse parti e accessori);Micro;1;2;0;2;0;0
28942;Fabbricazione di macchine e apparecchi per l'industria delle pelli, del cuoio e delle calzature (incluse parti e accessori);Piccola;1;38;38;0;3;0
28943;Fabbricazione di apparecchiature e di macchine per lavanderie e stirerie (incluse parti e accessori);Micro;6;19;15;4;1;0
28943;Fabbricazione di apparecchiature e di macchine per lavanderie e stirerie (incluse parti e accessori);Piccola;6;75;73;2;2;0
28950;Fabbricazione di macchine per l'industria della carta e del cartone (incluse parti e accessori);Micro;8;12;6;6;2;0
28950;Fabbricazione di macchine per l'industria della carta e del cartone (incluse parti e accessori);Piccola;3;88;82;6;3;3
28960;Fabbricazione di macchine per l'industria delle materie plastiche e della gomma (incluse parti e accessori);Media;1;69;66;3;1;0
28960;Fabbricazione di macchine per l'industria delle materie plastiche e della gomma (incluse parti e accessori);Micro;16;38;33;5;7;0
28960;Fabbricazione di macchine per l'industria delle materie plastiche e della gomma (incluse parti e accessori);Piccola;10;144;131;13;9;0
28991;Fabbricazione di macchine per la stampa e la legatoria (incluse parti e accessori);Micro;13;35;24;11;4;0
28991;Fabbricazione di macchine per la stampa e la legatoria (incluse parti e accessori);Piccola;3;55;55;0;5;0
28992;Fabbricazione di robot industriali per usi molteplici (incluse parti e accessori);Micro;7;23;20;3;3;1
28992;Fabbricazione di robot industriali per usi molteplici (incluse parti e accessori);Piccola;3;65;61;4;8;1
28993;Fabbricazione di apparecchi per istituti di bellezza e centri di benessere;Micro;4;11;8;3;0;0
28993;Fabbricazione di apparecchi per istituti di bellezza e centri di benessere;Piccola;1;18;16;2;2;0
28999;Fabbricazione di altre macchine per impieghi speciali nca (incluse parti e accessori);Micro;23;65;50;15;4;0
28999;Fabbricazione di altre macchine per impieghi speciali nca (incluse parti e accessori);Piccola;5;121;118;3;8;1
29100;Fabbricazione di autoveicoli;Micro;4;25;22;3;7;0
29200;Fabbricazione di carrozzerie per autoveicoli, rimorchi e semirimorchi;Micro;5;6;5;1;0;0
29200;Fabbricazione di carrozzerie per autoveicoli, rimorchi e semirimorchi;Piccola;4;106;100;6;0;1
29310;Fabbricazione di apparecchiature elettriche ed elettroniche per autoveicoli e loro motori;Micro;5;15;14;1;1;0
29310;Fabbricazione di apparecchiature elettriche ed elettroniche per autoveicoli e loro motori;Piccola;1;22;21;1;1;1
29320;Fabbricazione di altre parti ed accessori per autoveicoli;Grande;1;424;424;0;4;64
29320;Fabbricazione di altre parti ed accessori per autoveicoli;Media;2;195;195;0;4;6
29320;Fabbricazione di altre parti ed accessori per autoveicoli;Micro;19;82;69;13;0;0
29320;Fabbricazione di altre parti ed accessori per autoveicoli;Piccola;9;168;160;8;5;12
30110;Cantieri navali per costruzioni metalliche e non metalliche;Media;1;71;71;0;4;0
30110;Cantieri navali per costruzioni metalliche e non metalliche;Micro;12;25;17;8;4;0
30110;Cantieri navali per costruzioni metalliche e non metalliche;Piccola;3;40;38;2;0;0
30120;Costruzione di imbarcazioni da diporto e sportive;Micro;11;18;11;7;1;0
30120;Costruzione di imbarcazioni da diporto e sportive;Piccola;6;106;102;4;2;0
30200;Costruzione di materiale rotabile ferroviario, tranviario, filoviario, per metropolitane e per miniere;Micro;5;9;6;3;0;0
30200;Costruzione di materiale rotabile ferroviario, tranviario, filoviario, per metropolitane e per miniere;Piccola;3;50;50;0;1;0
30300;Fabbricazione di aeromobili, di veicoli spaziali e dei relativi dispositivi;Media;2;249;246;3;17;0
30300;Fabbricazione di aeromobili, di veicoli spaziali e dei relativi dispositivi;Micro;4;6;5;1;13;0
30911;Fabbricazione di motocicli e motoveicoli (inclusi i motori);Micro;4;2;1;1;0;0
30911;Fabbricazione di motocicli e motoveicoli (inclusi i motori);Piccola;3;51;51;0;4;0
30912;Fabbricazione di accessori e pezzi staccati per motocicli e ciclomotori;Micro;5;21;17;4;2;0
30921;Fabbricazione e montaggio di biciclette;Micro;3;4;0;4;0;0
30922;Fabbricazione di parti ed accessori per biciclette;Micro;1;1;0;1;0;0
30922;Fabbricazione di parti ed accessori per biciclette;Piccola;1;13;13;0;0;0
30923;Fabbricazione di veicoli per invalidi (incluse parti e accessori);Piccola;1;13;12;1;1;0
30990;Fabbricazione di veicoli a trazione manuale o animale;Micro;1;2;1;1;0;0
31012;Fabbricazione di altri mobili per ufficio e negozi;Media;2;246;246;0;3;1
31012;Fabbricazione di altri mobili per ufficio e negozi;Micro;21;62;40;22;2;0
31012;Fabbricazione di altri mobili per ufficio e negozi;Piccola;10;198;195;3;7;5
31020;Fabbricazione di mobili per cucina;Micro;4;16;12;4;0;0
31020;Fabbricazione di mobili per cucina;Piccola;1;22;21;1;0;0
31030;Fabbricazione di materassi;Micro;6;22;13;9;1;1
31091;Fabbricazione di mobili per arredo domestico;Micro;30;60;27;33;2;0
31091;Fabbricazione di mobili per arredo domestico;Piccola;5;92;85;7;4;0
31092;Fabbricazione di sedie e sedili (esclusi quelli per aeromobili, autoveicoli, navi, treni, ufficio e negozi);Micro;2;7;2;5;1;0
31093;Fabbricazione di poltrone e divani;Micro;24;53;31;22;0;0
31093;Fabbricazione di poltrone e divani;Piccola;3;48;46;2;0;0
31094;Fabbricazione di parti e accessori di mobili;Micro;38;96;54;42;3;0
31094;Fabbricazione di parti e accessori di mobili;Piccola;5;65;55;10;2;1
31095;Finitura di mobili;Micro;12;25;13;12;0;0
31095;Finitura di mobili;Piccola;1;10;9;1;0;0
31099;Fabbricazione di altri mobili (inclusi quelli per arredo esterno);Micro;13;26;19;7;5;0
31099;Fabbricazione di altri mobili (inclusi quelli per arredo esterno);Piccola;2;52;50;2;0;0
32110;Coniazione di monete;Micro;3;13;10;3;0;0
32110;Coniazione di monete;Piccola;2;32;28;4;1;0
32121;Fabbricazione di oggetti di gioielleria ed oreficeria in metalli preziosi o rivestiti di metalli preziosi;Grande;1;334;334;0;7;11
32121;Fabbricazione di oggetti di gioielleria ed oreficeria in metalli preziosi o rivestiti di metalli preziosi;Media;1;90;86;4;5;0
32121;Fabbricazione di oggetti di gioielleria ed oreficeria in metalli preziosi o rivestiti di metalli preziosi;Micro;242;490;198;292;12;0
32121;Fabbricazione di oggetti di gioielleria ed oreficeria in metalli preziosi o rivestiti di metalli preziosi;Piccola;20;376;357;19;19;0
32122;Lavorazione di pietre preziose e semipreziose per gioielleria e per uso industriale;Micro;48;61;5;56;0;0
32122;Lavorazione di pietre preziose e semipreziose per gioielleria e per uso industriale;Piccola;1;18;16;2;1;0
32130;Fabbricazione di bigiotteria e articoli simili;Micro;114;207;69;138;20;0
32130;Fabbricazione di bigiotteria e articoli simili;Piccola;3;33;26;7;7;0
32200;Fabbricazione di strumenti musicali (incluse parti e accessori);Micro;20;25;0;25;0;0
32300;Fabbricazione di articoli sportivi;Media;1;66;66;0;0;2
32300;Fabbricazione di articoli sportivi;Micro;7;9;2;7;0;0
32300;Fabbricazione di articoli sportivi;Piccola;3;56;52;4;3;0
32401;Fabbricazione di giochi (inclusi i giochi elettronici);Micro;14;37;28;9;1;0
32401;Fabbricazione di giochi (inclusi i giochi elettronici);Piccola;5;69;66;3;3;0
32402;Fabbricazione di giocattoli (inclusi i tricicli e gli strumenti musicali giocattolo);Micro;5;7;3;4;0;0
32402;Fabbricazione di giocattoli (inclusi i tricicli e gli strumenti musicali giocattolo);Piccola;3;47;40;7;3;0
32501;Fabbricazione di mobili per uso medico, apparecchi medicali, di materiale medico-chirurgico e veterinario, di apparecchi e strumenti per odontoiatria (incluse parti staccate e accessori);Media;1;214;214;0;1;6
32501;Fabbricazione di mobili per uso medico, apparecchi medicali, di materiale medico-chirurgico e veterinario, di apparecchi e strumenti per odontoiatria (incluse parti staccate e accessori);Micro;12;43;33;10;4;0
32501;Fabbricazione di mobili per uso medico, apparecchi medicali, di materiale medico-chirurgico e veterinario, di apparecchi e strumenti per odontoiatria (incluse parti staccate e accessori);Piccola;4;82;78;4;4;0
32502;Fabbricazione di protesi dentarie (inclusa riparazione);Media;1;90;88;2;1;0
32502;Fabbricazione di protesi dentarie (inclusa riparazione);Micro;525;994;279;715;6;0
32502;Fabbricazione di protesi dentarie (inclusa riparazione);Piccola;7;105;92;13;7;0
32503;Fabbricazione di protesi ortopediche, altre protesi ed ausili (inclusa riparazione);Micro;18;54;33;21;2;0
32503;Fabbricazione di protesi ortopediche, altre protesi ed ausili (inclusa riparazione);Piccola;5;69;63;6;3;0
32504;Fabbricazione di lenti oftalmiche;Media;1;199;199;0;2;3
32504;Fabbricazione di lenti oftalmiche;Micro;1;3;2;1;0;0
32505;Fabbricazione di armature per occhiali di qualsiasi tipo| montatura in serie di occhiali comuni;Micro;7;25;16;9;1;0
32505;Fabbricazione di armature per occhiali di qualsiasi tipo| montatura in serie di occhiali comuni;Piccola;1;17;17;0;5;0
32910;Fabbricazione di scope e spazzole;Micro;3;9;4;5;1;1
32991;Fabbricazione di attrezzature ed articoli di vestiario protettivi di sicurezza;Micro;7;28;26;2;1;0
32991;Fabbricazione di attrezzature ed articoli di vestiario protettivi di sicurezza;Piccola;2;50;47;3;1;0
32992;Fabbricazione di ombrelli, bottoni, chiusure lampo, parrucche e affini;Media;1;159;159;0;0;0
32992;Fabbricazione di ombrelli, bottoni, chiusure lampo, parrucche e affini;Micro;16;67;49;18;5;0
32992;Fabbricazione di ombrelli, bottoni, chiusure lampo, parrucche e affini;Piccola;2;36;32;4;3;0
32993;Fabbricazione di oggetti di cancelleria;Micro;16;32;16;16;2;0
32993;Fabbricazione di oggetti di cancelleria;Piccola;2;49;45;4;5;1
32999;Fabbricazione di altri articoli nca;Micro;73;142;65;77;5;0
32999;Fabbricazione di altri articoli nca;Piccola;1;13;13;0;2;0
33110;Riparazione e manutenzione di prodotti in metallo;Media;2;175;174;1;1;0
33110;Riparazione e manutenzione di prodotti in metallo;Micro;57;118;50;68;4;0
33110;Riparazione e manutenzione di prodotti in metallo;Piccola;4;76;74;2;1;1
33121;Riparazione e manutenzione di macchine di impiego generale;Micro;33;80;44;36;0;0
33121;Riparazione e manutenzione di macchine di impiego generale;Piccola;2;33;32;1;1;0
33122;Riparazione e manutenzione di forni, fornaci e bruciatori;Micro;10;27;16;11;0;0
33122;Riparazione e manutenzione di forni, fornaci e bruciatori;Piccola;2;23;22;1;1;0
33123;Riparazione e manutenzione di macchine e apparecchi di sollevamento e movimentazione (esclusi ascensori);Media;1;52;51;1;1;0
33123;Riparazione e manutenzione di macchine e apparecchi di sollevamento e movimentazione (esclusi ascensori);Micro;17;69;52;17;5;0
33123;Riparazione e manutenzione di macchine e apparecchi di sollevamento e movimentazione (esclusi ascensori);Piccola;6;97;90;7;5;0
33124;Riparazione e manutenzione di attrezzature di uso non domestico per la refrigerazione e la ventilazione;Micro;11;28;14;14;0;0
33124;Riparazione e manutenzione di attrezzature di uso non domestico per la refrigerazione e la ventilazione;Piccola;4;85;83;2;13;0
33125;Riparazione e manutenzione di altre macchine di impiego generale;Media;1;103;103;0;1;6
33125;Riparazione e manutenzione di altre macchine di impiego generale;Micro;129;259;122;137;22;0
33125;Riparazione e manutenzione di altre macchine di impiego generale;Piccola;15;242;226;16;12;8
33127;Riparazione e manutenzione di altre macchine per l'agricoltura, la silvicoltura e la zootecnia;Micro;4;8;3;5;0;0
33129;Riparazione e manutenzione di altre macchine per impieghi speciali (incluse le macchine utensili);Micro;53;94;43;51;2;0
33129;Riparazione e manutenzione di altre macchine per impieghi speciali (incluse le macchine utensili);Piccola;7;114;103;11;1;1
33130;Riparazione e manutenzione di apparecchiature elettroniche ed ottiche (escluse quelle per le telecomunicazioni ed i computer);Micro;131;243;93;150;8;5
33130;Riparazione e manutenzione di apparecchiature elettroniche ed ottiche (escluse quelle per le telecomunicazioni ed i computer);Piccola;12;160;155;5;2;1
33140;Riparazione e manutenzione di apparecchiature elettriche (esclusi gli elettrodomestici);Micro;42;116;83;33;6;0
33140;Riparazione e manutenzione di apparecchiature elettriche (esclusi gli elettrodomestici);Piccola;1;23;22;1;1;0
33150;Riparazione e manutenzione di navi commerciali e imbarcazioni da diporto (esclusi i loro motori);Micro;12;27;18;9;4;0
33150;Riparazione e manutenzione di navi commerciali e imbarcazioni da diporto (esclusi i loro motori);Piccola;2;22;22;0;0;0
33160;Riparazione e manutenzione di aeromobili e di veicoli spaziali;Micro;2;11;11;0;2;0
33170;Riparazione e manutenzione di materiale rotabile ferroviario, tranviario, filoviario e per metropolitane (esclusi i loro motori);Media;2;162;161;1;6;2
33170;Riparazione e manutenzione di materiale rotabile ferroviario, tranviario, filoviario e per metropolitane (esclusi i loro motori);Micro;3;18;17;1;0;0
33190;Riparazione di altre apparecchiature;Micro;12;34;25;9;0;0
33200;Installazione di macchine ed apparecchiature industriali;Media;5;448;445;3;24;14
33200;Installazione di macchine ed apparecchiature industriali;Micro;203;517;364;153;75;0
33200;Installazione di macchine ed apparecchiature industriali;Piccola;42;794;760;34;44;6
35110;Produzione di energia elettrica;Grande;1;1575;1575;0;1;11
35110;Produzione di energia elettrica;Media;6;627;627;0;10;64
35110;Produzione di energia elettrica;Micro;426;198;138;60;72;3
35110;Produzione di energia elettrica;Piccola;35;608;599;9;36;18
35120;Trasmissione di energia elettrica;Micro;1;0;0;0;1;0
35140;Commercio di energia elettrica;Grande;1;997;997;0;0;1
35140;Commercio di energia elettrica;Media;5;496;496;0;2;12
35140;Commercio di energia elettrica;Micro;33;50;41;9;16;1
35140;Commercio di energia elettrica;Piccola;9;182;182;0;13;3
35210;Produzione di gas;Micro;1;4;4;0;0;0
35220;Distribuzione di combustibili gassosi mediante condotte;Grande;2;1836;1836;0;10;4
35220;Distribuzione di combustibili gassosi mediante condotte;Micro;10;13;9;4;8;0
35220;Distribuzione di combustibili gassosi mediante condotte;Piccola;3;54;51;3;2;0
35230;Commercio di gas distribuito mediante condotte;Media;2;431;431;0;3;12
35230;Commercio di gas distribuito mediante condotte;Micro;31;71;65;6;22;1
35230;Commercio di gas distribuito mediante condotte;Piccola;11;219;214;5;9;2
35300;Fornitura di vapore e aria condizionata;Media;1;83;83;0;2;0
35300;Fornitura di vapore e aria condizionata;Micro;8;22;22;0;6;0
35300;Fornitura di vapore e aria condizionata;Piccola;5;95;94;1;12;7
36000;Raccolta, trattamento e fornitura di acqua;Grande;1;605;605;0;7;0
36000;Raccolta, trattamento e fornitura di acqua;Micro;12;25;23;2;4;0
36000;Raccolta, trattamento e fornitura di acqua;Piccola;1;35;35;0;6;0
37000;Raccolta e depurazione delle acque di scarico;Micro;17;65;46;19;2;0
37000;Raccolta e depurazione delle acque di scarico;Piccola;7;141;140;1;10;2
38110;Raccolta di rifiuti solidi non pericolosi;Micro;19;60;43;17;0;0
38110;Raccolta di rifiuti solidi non pericolosi;Piccola;6;85;78;7;11;0
38120;Raccolta di rifiuti pericolosi solidi e non solidi;Micro;3;11;11;0;0;0
38120;Raccolta di rifiuti pericolosi solidi e non solidi;Piccola;4;60;56;4;5;0
38210;Trattamento e smaltimento di rifiuti non pericolosi| produzione di compost;Grande;1;3450;3450;0;6;0
38210;Trattamento e smaltimento di rifiuti non pericolosi| produzione di compost;Micro;35;102;82;20;14;2
38210;Trattamento e smaltimento di rifiuti non pericolosi| produzione di compost;Piccola;3;72;70;2;1;0
38220;Trattamento e smaltimento di rifiuti pericolosi;Micro;8;11;7;4;2;0
38220;Trattamento e smaltimento di rifiuti pericolosi;Piccola;4;121;116;5;5;1
38311;Demolizione di carcasse;Micro;7;22;11;11;0;0
38321;Recupero e preparazione per il riciclaggio di cascami e rottami metallici;Micro;17;68;39;29;4;0
38321;Recupero e preparazione per il riciclaggio di cascami e rottami metallici;Piccola;4;91;87;4;5;1
38322;Recupero e preparazione per il riciclaggio di materiale plastico per produzione di materie prime plastiche, resine sintetiche;Media;1;53;53;0;0;0
38322;Recupero e preparazione per il riciclaggio di materiale plastico per produzione di materie prime plastiche, resine sintetiche;Micro;7;22;11;11;0;0
38322;Recupero e preparazione per il riciclaggio di materiale plastico per produzione di materie prime plastiche, resine sintetiche;Piccola;1;11;10;1;1;6
38323;Recupero e preparazione per il riciclaggio dei rifiuti solidi urbani, industriali e biomasse;Media;2;298;298;0;31;0
38323;Recupero e preparazione per il riciclaggio dei rifiuti solidi urbani, industriali e biomasse;Micro;19;51;46;5;13;1
38323;Recupero e preparazione per il riciclaggio dei rifiuti solidi urbani, industriali e biomasse;Piccola;7;110;109;1;8;2
39000;Attività di risanamento e altri servizi di gestione dei rifiuti;Media;1;124;124;0;6;0
39000;Attività di risanamento e altri servizi di gestione dei rifiuti;Micro;20;53;46;7;5;1
39000;Attività di risanamento e altri servizi di gestione dei rifiuti;Piccola;4;83;81;2;4;32
41100;Sviluppo di progetti immobiliari senza costruzione;Media;3;182;161;21;5;0
41100;Sviluppo di progetti immobiliari senza costruzione;Micro;372;346;208;138;63;2
41100;Sviluppo di progetti immobiliari senza costruzione;Piccola;7;184;167;17;23;0
41200;Costruzione di edifici residenziali e non residenziali;Grande;1;606;606;0;11;0
41200;Costruzione di edifici residenziali e non residenziali;Media;51;4097;4069;28;28;5
41200;Costruzione di edifici residenziali e non residenziali;Micro;2592;3337;2087;1250;311;1
41200;Costruzione di edifici residenziali e non residenziali;Piccola;251;5341;5160;181;134;3
42110;Costruzione di strade, autostrade e piste aeroportuali;Media;4;346;345;1;1;2
42110;Costruzione di strade, autostrade e piste aeroportuali;Micro;48;110;98;12;7;0
42110;Costruzione di strade, autostrade e piste aeroportuali;Piccola;13;252;242;10;7;0
42120;Costruzione di linee ferroviarie e metropolitane;Media;3;351;350;1;6;13
42120;Costruzione di linee ferroviarie e metropolitane;Micro;5;7;6;1;1;0
42130;Costruzione di ponti e gallerie;Media;1;89;89;0;0;0
42130;Costruzione di ponti e gallerie;Micro;3;8;8;0;0;0
42210;Costruzione di opere di pubblica utilità per il trasporto di fluidi;Media;2;169;169;0;3;6
42210;Costruzione di opere di pubblica utilità per il trasporto di fluidi;Piccola;1;44;44;0;7;0
42220;Costruzione di opere di pubblica utilità per l'energia elettrica e le telecomunicazioni;Grande;1;3936;3936;0;6;33
42220;Costruzione di opere di pubblica utilità per l'energia elettrica e le telecomunicazioni;Micro;3;1;0;1;0;0
42220;Costruzione di opere di pubblica utilità per l'energia elettrica e le telecomunicazioni;Piccola;4;96;93;3;0;0
42910;Costruzione di opere idrauliche;Media;1;85;85;0;13;0
42910;Costruzione di opere idrauliche;Micro;1;9;8;1;0;0
42910;Costruzione di opere idrauliche;Piccola;4;64;62;2;1;0
42990;Costruzione di altre opere di ingegneria civile nca;Grande;1;290;290;0;4;0
42990;Costruzione di altre opere di ingegneria civile nca;Micro;68;84;53;31;14;0
42990;Costruzione di altre opere di ingegneria civile nca;Piccola;9;175;168;7;3;0
43110;Demolizione;Micro;22;43;30;13;2;0
43110;Demolizione;Piccola;4;85;79;6;0;0
43120;Preparazione del cantiere edile e sistemazione del terreno;Micro;27;76;55;21;4;0
43120;Preparazione del cantiere edile e sistemazione del terreno;Piccola;8;176;172;4;15;0
43130;Trivellazioni e perforazioni;Micro;8;15;10;5;1;0
43130;Trivellazioni e perforazioni;Piccola;3;51;45;6;2;0
43210;Installazione di impianti elettrici ed elettronici (inclusa manutenzione e riparazione);Media;7;630;583;47;19;1
43210;Installazione di impianti elettrici ed elettronici (inclusa manutenzione e riparazione);Micro;1146;2415;1194;1221;104;4
43210;Installazione di impianti elettrici ed elettronici (inclusa manutenzione e riparazione);Piccola;90;1693;1585;108;72;20
43220;Installazione di impianti idraulici, di riscaldamento e di condizionamento dell'aria (inclusa manutenzione e riparazione);Grande;1;2666;2666;0;20;14
43220;Installazione di impianti idraulici, di riscaldamento e di condizionamento dell'aria (inclusa manutenzione e riparazione);Media;5;485;480;5;14;3
43220;Installazione di impianti idraulici, di riscaldamento e di condizionamento dell'aria (inclusa manutenzione e riparazione);Micro;939;2134;1073;1061;97;2
43220;Installazione di impianti idraulici, di riscaldamento e di condizionamento dell'aria (inclusa manutenzione e riparazione);Piccola;84;1372;1279;93;66;26
43290;Altri lavori di costruzione e installazione;Grande;1;482;482;0;15;0
43290;Altri lavori di costruzione e installazione;Media;2;109;109;0;4;1
43290;Altri lavori di costruzione e installazione;Micro;358;761;441;320;28;0
43290;Altri lavori di costruzione e installazione;Piccola;42;784;749;35;26;6
43310;Intonacatura e stuccatura;Micro;166;338;158;180;2;0
43310;Intonacatura e stuccatura;Piccola;10;132;123;9;5;0
43320;Posa in opera di infissi, arredi, controsoffitti, pareti mobili e simili;Micro;258;438;163;275;6;0
43320;Posa in opera di infissi, arredi, controsoffitti, pareti mobili e simili;Piccola;11;152;139;13;0;0
43330;Rivestimento di pavimenti e di muri;Media;1;71;66;5;1;0
43330;Rivestimento di pavimenti e di muri;Micro;345;565;206;359;20;0
43330;Rivestimento di pavimenti e di muri;Piccola;6;89;77;12;10;0
43340;Tinteggiatura e posa in opera di vetri;Micro;548;736;150;586;1;0
43340;Tinteggiatura e posa in opera di vetri;Piccola;2;22;20;2;0;0
43390;Altri lavori di completamento e di finitura degli edifici;Media;2;132;131;1;1;0
43390;Altri lavori di completamento e di finitura degli edifici;Micro;2685;4775;2203;2572;103;1
43390;Altri lavori di completamento e di finitura degli edifici;Piccola;103;1813;1707;106;38;6
43910;Realizzazione di coperture;Micro;55;154;95;59;3;0
43910;Realizzazione di coperture;Piccola;12;217;196;21;3;0
43990;Altri lavori specializzati di costruzione nca;Media;7;714;709;5;22;6
43990;Altri lavori specializzati di costruzione nca;Micro;147;262;165;97;13;0
43990;Altri lavori specializzati di costruzione nca;Piccola;24;429;410;19;13;1
45110;Commercio di autovetture e di autoveicoli leggeri;Grande;2;834;834;0;1;43
45110;Commercio di autovetture e di autoveicoli leggeri;Media;13;1244;1235;9;27;28
45110;Commercio di autovetture e di autoveicoli leggeri;Micro;383;640;287;353;26;0
45110;Commercio di autovetture e di autoveicoli leggeri;Piccola;53;1048;985;63;66;8
45190;Commercio di altri autoveicoli;Media;1;74;72;2;3;0
45190;Commercio di altri autoveicoli;Micro;15;14;5;9;0;0
45190;Commercio di altri autoveicoli;Piccola;2;27;24;3;3;0
45201;Riparazioni meccaniche di autoveicoli;Micro;584;1283;478;805;22;0
45201;Riparazioni meccaniche di autoveicoli;Piccola;15;223;193;30;7;0
45202;Riparazione di carrozzerie di autoveicoli;Grande;1;734;734;0;1;44
45202;Riparazione di carrozzerie di autoveicoli;Micro;266;859;452;407;10;0
45202;Riparazione di carrozzerie di autoveicoli;Piccola;20;268;233;35;4;0
45203;Riparazione di impianti elettrici e di alimentazione per autoveicoli;Micro;116;215;59;156;0;0
45204;Riparazione e sostituzione di pneumatici per autoveicoli;Micro;26;59;24;35;2;0
45204;Riparazione e sostituzione di pneumatici per autoveicoli;Piccola;2;24;21;3;0;0
45209;Autolavaggio e altre attività di manutenzione;Micro;55;124;80;44;2;0
45209;Autolavaggio e altre attività di manutenzione;Piccola;4;90;88;2;0;0
45310;Commercio all'ingrosso ed intermediazione di parti e accessori di autoveicoli;Grande;1;586;586;0;9;31
45310;Commercio all'ingrosso ed intermediazione di parti e accessori di autoveicoli;Media;2;247;247;0;5;0
45310;Commercio all'ingrosso ed intermediazione di parti e accessori di autoveicoli;Micro;186;459;266;193;45;0
45310;Commercio all'ingrosso ed intermediazione di parti e accessori di autoveicoli;Piccola;33;582;537;45;28;4
45320;Commercio al dettaglio di parti e accessori di autoveicoli;Micro;87;231;111;120;3;0
45320;Commercio al dettaglio di parti e accessori di autoveicoli;Piccola;3;35;29;6;0;0
45401;Commercio all'ingrosso e al dettaglio ed intermediazione di motocicli e ciclomotori;Media;1;64;64;0;1;5
45401;Commercio all'ingrosso e al dettaglio ed intermediazione di motocicli e ciclomotori;Micro;85;220;126;94;11;0
45401;Commercio all'ingrosso e al dettaglio ed intermediazione di motocicli e ciclomotori;Piccola;11;150;136;14;1;0
45402;Commercio all'ingrosso e al dettaglio ed intermediazione di parti e accessori per motocicli e ciclomotori;Micro;33;63;30;33;5;0
45402;Commercio all'ingrosso e al dettaglio ed intermediazione di parti e accessori per motocicli e ciclomotori;Piccola;6;78;70;8;1;0
45403;Manutenzione e riparazione di motocicli e ciclomotori (inclusi i pneumatici);Micro;31;63;24;39;2;0
46110;Intermediari del commercio di materie prime agricole, di animali vivi, di materie prime tessili e di semilavorati| pelli grezze;Micro;79;131;50;81;15;0
46120;Intermediari del commercio di combustibili, minerali, metalli e prodotti chimici;Media;1;50;50;0;0;0
46120;Intermediari del commercio di combustibili, minerali, metalli e prodotti chimici;Micro;463;712;272;440;37;1
46120;Intermediari del commercio di combustibili, minerali, metalli e prodotti chimici;Piccola;10;179;177;2;11;1
46130;Intermediari del commercio di legname e materiali da costruzione;Micro;277;390;91;299;6;0
46130;Intermediari del commercio di legname e materiali da costruzione;Piccola;5;82;74;8;14;0
46140;Intermediari del commercio di macchinari, impianti industriali, navi e aeromobili, macchine agricole, macchine per ufficio, attrezzature per le telecomunicazioni, computer e loro periferiche;Micro;479;686;192;494;30;0
46140;Intermediari del commercio di macchinari, impianti industriali, navi e aeromobili, macchine agricole, macchine per ufficio, attrezzature per le telecomunicazioni, computer e loro periferiche;Piccola;15;230;222;8;12;3
46150;Intermediari del commercio di mobili, articoli per la casa e ferramenta;Media;1;51;51;0;0;1
46150;Intermediari del commercio di mobili, articoli per la casa e ferramenta;Micro;368;482;83;399;15;0
46150;Intermediari del commercio di mobili, articoli per la casa e ferramenta;Piccola;2;22;20;2;0;0
46160;Intermediari del commercio di prodotti tessili, abbigliamento, pellicce, calzature e articoli in pelle;Media;1;52;52;0;1;0
46160;Intermediari del commercio di prodotti tessili, abbigliamento, pellicce, calzature e articoli in pelle;Micro;786;1140;319;821;68;0
46160;Intermediari del commercio di prodotti tessili, abbigliamento, pellicce, calzature e articoli in pelle;Piccola;9;126;112;14;22;1
46170;Intermediari del commercio di prodotti alimentari, bevande e tabacco;Media;1;126;126;0;0;0
46170;Intermediari del commercio di prodotti alimentari, bevande e tabacco;Micro;515;643;96;547;13;0
46170;Intermediari del commercio di prodotti alimentari, bevande e tabacco;Piccola;5;111;105;6;2;1
46181;Intermediari del commercio di prodotti di carta, cancelleria, libri;Micro;391;508;105;403;14;0
46181;Intermediari del commercio di prodotti di carta, cancelleria, libri;Piccola;4;54;54;0;0;1
46182;Intermediari del commercio di elettronica di consumo audio e video, materiale elettrico per uso domestico, elettrodomestici;Media;3;317;315;2;46;0
46182;Intermediari del commercio di elettronica di consumo audio e video, materiale elettrico per uso domestico, elettrodomestici;Micro;322;411;80;331;39;0
46182;Intermediari del commercio di elettronica di consumo audio e video, materiale elettrico per uso domestico, elettrodomestici;Piccola;7;124;120;4;4;1
46183;Intermediari del commercio di prodotti farmaceutici e di cosmetici;Micro;547;610;63;547;7;0
46183;Intermediari del commercio di prodotti farmaceutici e di cosmetici;Piccola;2;41;40;1;10;0
46189;Intermediari del commercio di attrezzature sportive, biciclette e altri prodotti nca;Micro;448;518;50;468;8;0
46189;Intermediari del commercio di attrezzature sportive, biciclette e altri prodotti nca;Piccola;4;70;69;1;7;1
46190;Intermediari del commercio di vari prodotti senza prevalenza di alcuno;Micro;1724;1965;238;1727;161;2
46190;Intermediari del commercio di vari prodotti senza prevalenza di alcuno;Piccola;15;281;276;5;23;2
46211;Commercio all'ingrosso di cereali e legumi secchi;Micro;19;44;39;5;6;0
46211;Commercio all'ingrosso di cereali e legumi secchi;Piccola;3;48;43;5;2;0
46212;Commercio all'ingrosso di sementi e alimenti per il bestiame (mangimi), piante officinali, semi oleosi, patate da semina, tabacco grezzo;Media;1;128;128;0;0;5
46212;Commercio all'ingrosso di sementi e alimenti per il bestiame (mangimi), piante officinali, semi oleosi, patate da semina, tabacco grezzo;Micro;22;44;38;6;6;0
46212;Commercio all'ingrosso di sementi e alimenti per il bestiame (mangimi), piante officinali, semi oleosi, patate da semina, tabacco grezzo;Piccola;1;15;15;0;0;0
46220;Commercio all'ingrosso di fiori e piante;Micro;50;136;75;61;3;0
46220;Commercio all'ingrosso di fiori e piante;Piccola;3;47;44;3;3;0
46230;Commercio all'ingrosso di animali vivi;Micro;17;20;8;12;2;0
46241;Commercio all'ingrosso di cuoio e pelli gregge e lavorate (escluse le pelli per pellicceria);Micro;23;55;40;15;3;0
46241;Commercio all'ingrosso di cuoio e pelli gregge e lavorate (escluse le pelli per pellicceria);Piccola;3;60;57;3;1;2
46242;Commercio all'ingrosso di pelli gregge e lavorate per pellicceria;Media;1;86;86;0;8;3
46242;Commercio all'ingrosso di pelli gregge e lavorate per pellicceria;Micro;12;37;24;13;0;0
46242;Commercio all'ingrosso di pelli gregge e lavorate per pellicceria;Piccola;1;16;15;1;1;0
46311;Commercio all'ingrosso di frutta e ortaggi freschi;Micro;149;505;332;173;25;3
46311;Commercio all'ingrosso di frutta e ortaggi freschi;Piccola;44;698;615;83;18;2
46312;Commercio all'ingrosso di frutta e ortaggi conservati;Micro;4;18;12;6;0;0
46312;Commercio all'ingrosso di frutta e ortaggi conservati;Piccola;2;21;20;1;2;0
46321;Commercio all'ingrosso di carne fresca, congelata e surgelata;Micro;34;71;43;28;2;0
46321;Commercio all'ingrosso di carne fresca, congelata e surgelata;Piccola;7;88;70;18;5;0
46322;Commercio all'ingrosso di prodotti di salumeria;Micro;4;7;5;2;0;0
46322;Commercio all'ingrosso di prodotti di salumeria;Piccola;1;15;11;4;0;0
46331;Commercio all'ingrosso di prodotti lattiero-caseari e di uova;Grande;2;1515;1515;0;0;9
46331;Commercio all'ingrosso di prodotti lattiero-caseari e di uova;Micro;33;58;33;25;3;0
46331;Commercio all'ingrosso di prodotti lattiero-caseari e di uova;Piccola;7;134;132;2;1;0
46332;Commercio all'ingrosso di oli e grassi alimentari di origine vegetale o animale;Micro;10;14;5;9;5;0
46341;Commercio all'ingrosso di bevande alcoliche;Micro;84;137;66;71;10;0
46341;Commercio all'ingrosso di bevande alcoliche;Piccola;6;129;127;2;15;1
46342;Commercio all'ingrosso di bevande non alcoliche;Micro;21;51;31;20;8;0
46342;Commercio all'ingrosso di bevande non alcoliche;Piccola;2;28;26;2;1;0
46350;Commercio all'ingrosso di prodotti del tabacco;Micro;4;12;8;4;0;0
46360;Commercio all'ingrosso di zucchero, cioccolato, dolciumi e prodotti da forno;Micro;37;99;70;29;9;1
46360;Commercio all'ingrosso di zucchero, cioccolato, dolciumi e prodotti da forno;Piccola;3;41;38;3;4;0
46370;Commercio all'ingrosso di caffè, tè, cacao e spezie;Micro;24;50;28;22;5;1
46370;Commercio all'ingrosso di caffè, tè, cacao e spezie;Piccola;1;21;19;2;6;0
46381;Commercio all'ingrosso di prodotti della pesca freschi;Micro;22;59;39;20;6;0
46381;Commercio all'ingrosso di prodotti della pesca freschi;Piccola;7;93;87;6;4;0
46382;Commercio all'ingrosso di prodotti della pesca congelati, surgelati, conservati, secchi;Micro;26;64;38;26;3;1
46382;Commercio all'ingrosso di prodotti della pesca congelati, surgelati, conservati, secchi;Piccola;5;108;103;5;3;26
46383;Commercio all'ingrosso di pasti e piatti pronti;Micro;1;0;0;0;0;0
46389;Commercio all'ingrosso di altri prodotti alimentari;Grande;1;259;259;0;5;2
46389;Commercio all'ingrosso di altri prodotti alimentari;Media;3;266;266;0;16;5
46389;Commercio all'ingrosso di altri prodotti alimentari;Micro;129;217;125;92;13;0
46389;Commercio all'ingrosso di altri prodotti alimentari;Piccola;5;145;141;4;7;0
46391;Commercio all'ingrosso non specializzato di prodotti surgelati;Micro;9;21;12;9;3;0
46392;Commercio all'ingrosso non specializzato di altri prodotti alimentari, bevande e tabacco;Media;1;160;160;0;164;0
46392;Commercio all'ingrosso non specializzato di altri prodotti alimentari, bevande e tabacco;Micro;58;153;103;50;6;1
46392;Commercio all'ingrosso non specializzato di altri prodotti alimentari, bevande e tabacco;Piccola;8;127;117;10;23;9
46411;Commercio all'ingrosso di tessuti;Micro;125;302;197;105;31;1
46411;Commercio all'ingrosso di tessuti;Piccola;14;262;253;9;13;3
46412;Commercio all'ingrosso di articoli di merceria, filati e passamaneria;Micro;41;93;59;34;12;0
46412;Commercio all'ingrosso di articoli di merceria, filati e passamaneria;Piccola;6;94;90;4;4;0
46419;Commercio all'ingrosso di altri articoli tessili;Media;1;80;79;1;2;1
46419;Commercio all'ingrosso di altri articoli tessili;Micro;41;97;63;34;11;2
46421;Commercio all'ingrosso di abbigliamento e accessori;Grande;1;342;342;0;0;3
46421;Commercio all'ingrosso di abbigliamento e accessori;Media;11;1295;1295;0;55;28
46421;Commercio all'ingrosso di abbigliamento e accessori;Micro;646;1183;609;574;146;6
46421;Commercio all'ingrosso di abbigliamento e accessori;Piccola;37;747;707;40;69;3
46422;Commercio all'ingrosso di articoli in pelliccia;Micro;15;29;19;10;4;0
46422;Commercio all'ingrosso di articoli in pelliccia;Piccola;1;17;15;2;1;0
46423;Commercio all'ingrosso di camicie, biancheria intima, maglieria e simili;Micro;37;78;45;33;5;0
46423;Commercio all'ingrosso di camicie, biancheria intima, maglieria e simili;Piccola;4;64;63;1;4;0
46424;Commercio all'ingrosso di calzature e accessori;Media;1;57;57;0;0;0
46424;Commercio all'ingrosso di calzature e accessori;Micro;68;153;96;57;12;0
46424;Commercio all'ingrosso di calzature e accessori;Piccola;11;215;205;10;29;4
46431;Commercio all'ingrosso di elettrodomestici, di elettronica di consumo audio e video;Media;7;607;604;3;22;11
46431;Commercio all'ingrosso di elettrodomestici, di elettronica di consumo audio e video;Micro;128;304;223;81;34;2
46431;Commercio all'ingrosso di elettrodomestici, di elettronica di consumo audio e video;Piccola;21;414;403;11;25;1
46432;Commercio all'ingrosso di supporti registrati, audio, video (Cd, Dvd e altri supporti);Media;3;308;306;2;12;4
46432;Commercio all'ingrosso di supporti registrati, audio, video (Cd, Dvd e altri supporti);Micro;29;82;47;35;7;0
46432;Commercio all'ingrosso di supporti registrati, audio, video (Cd, Dvd e altri supporti);Piccola;7;142;138;4;15;0
46433;Commercio all'ingrosso di articoli per fotografia, cinematografia e ottica;Media;1;54;54;0;0;17
46433;Commercio all'ingrosso di articoli per fotografia, cinematografia e ottica;Micro;49;125;89;36;14;0
46433;Commercio all'ingrosso di articoli per fotografia, cinematografia e ottica;Piccola;10;222;214;8;5;3
46441;Commercio all'ingrosso di vetreria e cristalleria;Media;1;242;242;0;1;0
46441;Commercio all'ingrosso di vetreria e cristalleria;Micro;13;33;24;9;2;0
46441;Commercio all'ingrosso di vetreria e cristalleria;Piccola;4;94;87;7;4;0
46442;Commercio all'ingrosso di ceramiche e porcellana;Media;1;63;63;0;1;0
46442;Commercio all'ingrosso di ceramiche e porcellana;Micro;16;43;35;8;2;1
46442;Commercio all'ingrosso di ceramiche e porcellana;Piccola;5;88;78;10;3;0
46443;Commercio all'ingrosso di saponi, detersivi e altri prodotti per la pulizia;Media;1;167;166;1;6;2
46443;Commercio all'ingrosso di saponi, detersivi e altri prodotti per la pulizia;Micro;36;67;31;36;5;0
46443;Commercio all'ingrosso di saponi, detersivi e altri prodotti per la pulizia;Piccola;3;39;38;1;11;1
46444;Commercio all'ingrosso di coltelleria, posateria e pentolame;Micro;8;27;20;7;2;0
46444;Commercio all'ingrosso di coltelleria, posateria e pentolame;Piccola;2;23;22;1;0;0
46450;Commercio all'ingrosso di profumi e cosmetici;Grande;1;403;403;0;1;35
46450;Commercio all'ingrosso di profumi e cosmetici;Media;8;1004;1004;0;43;78
46450;Commercio all'ingrosso di profumi e cosmetici;Micro;212;435;276;159;71;4
46450;Commercio all'ingrosso di profumi e cosmetici;Piccola;28;551;541;10;28;29
46461;Commercio all'ingrosso di medicinali;Grande;3;1978;1978;0;1;3
46461;Commercio all'ingrosso di medicinali;Media;22;2683;2680;3;19;47
46461;Commercio all'ingrosso di medicinali;Micro;158;368;258;110;46;2
46461;Commercio all'ingrosso di medicinali;Piccola;30;630;615;15;63;14
46462;Commercio all'ingrosso di prodotti botanici per uso farmaceutico;Micro;17;48;36;12;7;0
46463;Commercio all'ingrosso di articoli medicali ed ortopedici;Grande;2;799;799;0;1;20
46463;Commercio all'ingrosso di articoli medicali ed ortopedici;Media;8;666;664;2;18;1
46463;Commercio all'ingrosso di articoli medicali ed ortopedici;Micro;240;522;358;164;66;1
46463;Commercio all'ingrosso di articoli medicali ed ortopedici;Piccola;53;1038;998;40;58;16
46471;Commercio all'ingrosso di mobili di qualsiasi materiale;Micro;135;250;138;112;30;0
46471;Commercio all'ingrosso di mobili di qualsiasi materiale;Piccola;6;112;106;6;4;4
46472;Commercio all'ingrosso di tappeti;Micro;14;35;21;14;1;0
46472;Commercio all'ingrosso di tappeti;Piccola;1;12;12;0;2;0
46473;Commercio all'ingrosso di articoli per l'illuminazione| materiale elettrico vario per uso domestico;Grande;1;430;430;0;2;7
46473;Commercio all'ingrosso di articoli per l'illuminazione| materiale elettrico vario per uso domestico;Media;1;103;102;1;0;0
46473;Commercio all'ingrosso di articoli per l'illuminazione| materiale elettrico vario per uso domestico;Micro;128;347;243;104;22;1
46473;Commercio all'ingrosso di articoli per l'illuminazione| materiale elettrico vario per uso domestico;Piccola;31;550;535;15;32;5
46480;Commercio all'ingrosso di orologi e di gioielleria;Grande;1;333;333;0;3;1
46480;Commercio all'ingrosso di orologi e di gioielleria;Media;2;207;207;0;3;3
46480;Commercio all'ingrosso di orologi e di gioielleria;Micro;306;642;332;310;44;0
46480;Commercio all'ingrosso di orologi e di gioielleria;Piccola;26;463;438;25;32;2
46491;Commercio all'ingrosso di carta, cartone e articoli di cartoleria;Media;6;448;448;0;18;8
46491;Commercio all'ingrosso di carta, cartone e articoli di cartoleria;Micro;193;436;270;166;46;1
46491;Commercio all'ingrosso di carta, cartone e articoli di cartoleria;Piccola;24;480;456;24;24;2
46492;Commercio all'ingrosso di libri, riviste e giornali;Micro;48;131;78;53;12;0
46492;Commercio all'ingrosso di libri, riviste e giornali;Piccola;2;41;37;4;0;0
46493;Commercio all'ingrosso di giochi e giocattoli;Grande;1;363;363;0;2;0
46493;Commercio all'ingrosso di giochi e giocattoli;Media;1;76;76;0;1;1
46493;Commercio all'ingrosso di giochi e giocattoli;Micro;35;92;61;31;6;0
46493;Commercio all'ingrosso di giochi e giocattoli;Piccola;7;101;95;6;4;0
46494;Commercio all'ingrosso di articoli sportivi (incluse le biciclette);Media;1;216;216;0;2;20
46494;Commercio all'ingrosso di articoli sportivi (incluse le biciclette);Micro;52;97;56;41;10;1
46494;Commercio all'ingrosso di articoli sportivi (incluse le biciclette);Piccola;10;161;151;10;22;0
46495;Commercio all'ingrosso di articoli in pelle| articoli da viaggio in qualsiasi materiale;Micro;52;111;60;51;1;0
46495;Commercio all'ingrosso di articoli in pelle| articoli da viaggio in qualsiasi materiale;Piccola;4;50;47;3;2;0
46499;Commercio all'ingrosso di vari prodotti di consumo non alimentare nca;Media;2;121;118;3;8;0
46499;Commercio all'ingrosso di vari prodotti di consumo non alimentare nca;Micro;445;910;473;437;59;0
46499;Commercio all'ingrosso di vari prodotti di consumo non alimentare nca;Piccola;32;612;597;15;38;17
46510;Commercio all'ingrosso di computer, apparecchiature informatiche periferiche e di software;Grande;2;724;723;1;40;0
46510;Commercio all'ingrosso di computer, apparecchiature informatiche periferiche e di software;Media;5;317;317;0;8;3
46510;Commercio all'ingrosso di computer, apparecchiature informatiche periferiche e di software;Micro;480;1095;627;468;129;0
46510;Commercio all'ingrosso di computer, apparecchiature informatiche periferiche e di software;Piccola;49;759;702;57;37;2
46520;Commercio all'ingrosso apparecchiature elettroniche per telecomunicazioni e componenti elettronici;Grande;2;881;881;0;5;0
46520;Commercio all'ingrosso apparecchiature elettroniche per telecomunicazioni e componenti elettronici;Media;4;445;443;2;18;5
46520;Commercio all'ingrosso apparecchiature elettroniche per telecomunicazioni e componenti elettronici;Micro;219;503;358;145;67;3
46520;Commercio all'ingrosso apparecchiature elettroniche per telecomunicazioni e componenti elettronici;Piccola;38;648;614;34;37;8
46610;Commercio all'ingrosso di macchine, accessori e utensili agricoli, inclusi i trattori;Micro;6;11;7;4;2;0
46610;Commercio all'ingrosso di macchine, accessori e utensili agricoli, inclusi i trattori;Piccola;5;80;76;4;3;0
46620;Commercio all'ingrosso di macchine utensili (incluse le relative parti intercambiabili);Media;2;161;158;3;6;0
46620;Commercio all'ingrosso di macchine utensili (incluse le relative parti intercambiabili);Micro;149;330;213;117;28;0
46620;Commercio all'ingrosso di macchine utensili (incluse le relative parti intercambiabili);Piccola;21;378;351;27;19;4
46630;Commercio all'ingrosso di macchine per le miniere, l'edilizia e l'ingegneria civile;Micro;45;100;62;38;8;0
46630;Commercio all'ingrosso di macchine per le miniere, l'edilizia e l'ingegneria civile;Piccola;6;95;89;6;1;0
46640;Commercio all'ingrosso di macchine per l'industria tessile, di macchine per cucire e per maglieria;Media;1;56;56;0;3;0
46640;Commercio all'ingrosso di macchine per l'industria tessile, di macchine per cucire e per maglieria;Micro;29;76;48;28;5;0
46640;Commercio all'ingrosso di macchine per l'industria tessile, di macchine per cucire e per maglieria;Piccola;4;49;47;2;8;0
46650;Commercio all'ingrosso di mobili per ufficio e negozi;Micro;26;66;39;27;3;0
46660;Commercio all'ingrosso di altre macchine e attrezzature per ufficio;Grande;1;822;822;0;3;21
46660;Commercio all'ingrosso di altre macchine e attrezzature per ufficio;Media;1;87;87;0;1;0
46660;Commercio all'ingrosso di altre macchine e attrezzature per ufficio;Micro;105;261;179;82;16;2
46660;Commercio all'ingrosso di altre macchine e attrezzature per ufficio;Piccola;18;355;332;23;15;5
46691;Commercio all'ingrosso di mezzi ed attrezzature di trasporto;Micro;20;28;18;10;2;0
46691;Commercio all'ingrosso di mezzi ed attrezzature di trasporto;Piccola;3;42;38;4;3;0
46692;Commercio all'ingrosso di materiale elettrico per impianti di uso industriale;Media;2;139;139;0;3;4
46692;Commercio all'ingrosso di materiale elettrico per impianti di uso industriale;Micro;73;166;122;44;9;1
46692;Commercio all'ingrosso di materiale elettrico per impianti di uso industriale;Piccola;8;195;192;3;14;0
46693;Commercio all'ingrosso di apparecchiature per parrucchieri, palestre, solarium e centri estetici;Micro;15;29;14;15;2;0
46693;Commercio all'ingrosso di apparecchiature per parrucchieri, palestre, solarium e centri estetici;Piccola;2;38;36;2;1;0
46699;Commercio all'ingrosso di altre macchine e attrezzature per l'industria, il commercio e la navigazione;Grande;1;2545;2545;0;72;106
46699;Commercio all'ingrosso di altre macchine e attrezzature per l'industria, il commercio e la navigazione;Media;9;1188;1185;3;13;20
46699;Commercio all'ingrosso di altre macchine e attrezzature per l'industria, il commercio e la navigazione;Micro;444;1049;731;318;86;17
46699;Commercio all'ingrosso di altre macchine e attrezzature per l'industria, il commercio e la navigazione;Piccola;57;981;938;43;45;2
46710;Commercio all'ingrosso di prodotti petroliferi e lubrificanti per autotrazione, di combustibili per riscaldamento;Grande;1;298;298;0;1;0
46710;Commercio all'ingrosso di prodotti petroliferi e lubrificanti per autotrazione, di combustibili per riscaldamento;Micro;89;213;166;47;32;1
46710;Commercio all'ingrosso di prodotti petroliferi e lubrificanti per autotrazione, di combustibili per riscaldamento;Piccola;18;356;338;18;41;6
46721;Commercio all'ingrosso di minerali metalliferi, di metalli ferrosi e prodotti semilavorati;Media;2;360;360;0;7;8
46721;Commercio all'ingrosso di minerali metalliferi, di metalli ferrosi e prodotti semilavorati;Micro;167;349;227;122;44;3
46721;Commercio all'ingrosso di minerali metalliferi, di metalli ferrosi e prodotti semilavorati;Piccola;15;232;220;12;14;0
46722;Commercio all'ingrosso di metalli non ferrosi e prodotti semilavorati;Media;1;92;89;3;0;1
46722;Commercio all'ingrosso di metalli non ferrosi e prodotti semilavorati;Micro;78;181;127;54;13;1
46722;Commercio all'ingrosso di metalli non ferrosi e prodotti semilavorati;Piccola;25;473;453;20;19;11
46731;Commercio all'ingrosso di legname, semilavorati in legno e legno artificiale;Micro;41;79;48;31;1;0
46731;Commercio all'ingrosso di legname, semilavorati in legno e legno artificiale;Piccola;4;112;111;1;4;0
46732;Commercio all'ingrosso di materiali da costruzione (inclusi gli apparecchi igienico-sanitari);Media;2;265;262;3;3;0
46732;Commercio all'ingrosso di materiali da costruzione (inclusi gli apparecchi igienico-sanitari);Micro;192;484;319;165;29;0
46732;Commercio all'ingrosso di materiali da costruzione (inclusi gli apparecchi igienico-sanitari);Piccola;39;618;577;41;15;5
46733;Commercio all'ingrosso di vetro piano;Micro;5;4;1;3;0;0
46734;Commercio all'ingrosso di carta da parati, colori e vernici;Media;1;174;174;0;2;0
46734;Commercio all'ingrosso di carta da parati, colori e vernici;Micro;68;196;113;83;25;0
46734;Commercio all'ingrosso di carta da parati, colori e vernici;Piccola;4;59;54;5;9;0
46741;Commercio all'ingrosso di articoli in ferro e in altri metalli (ferramenta);Grande;1;510;510;0;6;3
46741;Commercio all'ingrosso di articoli in ferro e in altri metalli (ferramenta);Media;1;86;85;1;2;0
46741;Commercio all'ingrosso di articoli in ferro e in altri metalli (ferramenta);Micro;161;451;274;177;18;0
46741;Commercio all'ingrosso di articoli in ferro e in altri metalli (ferramenta);Piccola;40;658;600;58;36;4
46742;Commercio all'ingrosso di apparecchi e accessori per impianti idraulici, di riscaldamento e di condizionamento;Media;7;740;736;4;13;5
46742;Commercio all'ingrosso di apparecchi e accessori per impianti idraulici, di riscaldamento e di condizionamento;Micro;111;264;172;92;24;0
46742;Commercio all'ingrosso di apparecchi e accessori per impianti idraulici, di riscaldamento e di condizionamento;Piccola;20;449;428;21;20;8
46750;Commercio all'ingrosso di prodotti chimici;Grande;1;333;333;0;4;8
46750;Commercio all'ingrosso di prodotti chimici;Media;11;1110;1103;7;34;13
46750;Commercio all'ingrosso di prodotti chimici;Micro;304;659;488;171;77;2
46750;Commercio all'ingrosso di prodotti chimici;Piccola;48;858;817;41;43;6
46761;Commercio all'ingrosso di fibre tessili gregge e semilavorate;Micro;19;31;22;9;3;0
46761;Commercio all'ingrosso di fibre tessili gregge e semilavorate;Piccola;4;101;101;0;6;0
46762;Commercio all'ingrosso di gomma greggia, materie plastiche in forme primarie e semilavorati;Media;1;85;85;0;1;2
46762;Commercio all'ingrosso di gomma greggia, materie plastiche in forme primarie e semilavorati;Micro;59;124;86;38;6;2
46762;Commercio all'ingrosso di gomma greggia, materie plastiche in forme primarie e semilavorati;Piccola;5;81;73;8;5;0
46763;Commercio all'ingrosso di imballaggi;Micro;60;113;66;47;7;0
46763;Commercio all'ingrosso di imballaggi;Piccola;8;106;102;4;4;0
46769;Commercio all'ingrosso di altri prodotti intermedi nca;Micro;63;158;103;55;14;0
46769;Commercio all'ingrosso di altri prodotti intermedi nca;Piccola;8;106;99;7;2;1
46771;Commercio all'ingrosso di rottami e sottoprodotti della lavorazione industriale metallici;Micro;57;190;120;70;9;0
46771;Commercio all'ingrosso di rottami e sottoprodotti della lavorazione industriale metallici;Piccola;4;48;43;5;1;0
46772;Commercio all'ingrosso di altri materiali di recupero non metallici (vetro, carta, cartoni eccetera)| sottoprodotti non metallici della lavorazione industriale (cascami);Micro;33;84;50;34;5;0
46772;Commercio all'ingrosso di altri materiali di recupero non metallici (vetro, carta, cartoni eccetera)| sottoprodotti non metallici della lavorazione industriale (cascami);Piccola;7;97;89;8;3;0
46900;Commercio all'ingrosso non specializzato;Media;4;228;228;0;0;7
46900;Commercio all'ingrosso non specializzato;Micro;713;1676;1122;554;164;3
46900;Commercio all'ingrosso non specializzato;Piccola;96;1688;1605;83;75;17
47111;Ipermercati;Grande;3;21094;21069;25;11;797
47111;Ipermercati;Media;1;58;58;0;0;19
47112;Supermercati;Grande;4;20951;20951;0;35;120
47112;Supermercati;Media;5;390;383;7;1;11
47112;Supermercati;Micro;22;64;42;22;2;0
47112;Supermercati;Piccola;13;252;193;59;2;2
47113;Discount di alimentari;Micro;8;16;9;7;0;0
47113;Discount di alimentari;Piccola;1;11;9;2;0;0
47114;Minimercati ed altri esercizi non specializzati di alimentari vari;Micro;265;660;305;355;12;4
47114;Minimercati ed altri esercizi non specializzati di alimentari vari;Piccola;13;221;206;15;2;8
47115;Commercio al dettaglio di prodotti surgelati;Media;1;50;50;0;3;0
47115;Commercio al dettaglio di prodotti surgelati;Micro;4;13;8;5;1;0
47115;Commercio al dettaglio di prodotti surgelati;Piccola;1;12;12;0;0;0
47191;Grandi magazzini;Grande;1;1310;1310;0;18;3
47191;Grandi magazzini;Media;7;627;627;0;2;2
47191;Grandi magazzini;Micro;12;54;38;16;6;0
47191;Grandi magazzini;Piccola;7;141;135;6;9;1
47192;Commercio al dettaglio in esercizi non specializzati di computer, periferiche, attrezzature per le telecomunicazioni, elettronica di consumo audio e video, elettrodomestici;Micro;31;86;54;32;19;0
47192;Commercio al dettaglio in esercizi non specializzati di computer, periferiche, attrezzature per le telecomunicazioni, elettronica di consumo audio e video, elettrodomestici;Piccola;1;21;21;0;1;0
47199;Empori ed altri negozi non specializzati di vari prodotti non alimentari;Grande;1;294;294;0;0;0
47199;Empori ed altri negozi non specializzati di vari prodotti non alimentari;Media;1;59;59;0;0;0
47199;Empori ed altri negozi non specializzati di vari prodotti non alimentari;Micro;94;181;72;109;4;0
47199;Empori ed altri negozi non specializzati di vari prodotti non alimentari;Piccola;2;24;24;0;1;0
47210;Commercio al dettaglio di frutta e verdura;Micro;217;461;112;349;5;0
47220;Commercio al dettaglio di carni e di prodotti a base di carne;Micro;289;662;219;443;12;0
47220;Commercio al dettaglio di carni e di prodotti a base di carne;Piccola;6;69;61;8;3;0
47230;Commercio al dettaglio di pesci, crostacei e molluschi;Micro;33;89;47;42;3;0
47230;Commercio al dettaglio di pesci, crostacei e molluschi;Piccola;3;39;35;4;2;0
47241;Commercio al dettaglio di pane;Micro;260;558;185;373;5;0
47241;Commercio al dettaglio di pane;Piccola;4;58;53;5;0;0
47242;Commercio al dettaglio di torte, dolciumi, confetteria;Micro;59;168;80;88;2;0
47242;Commercio al dettaglio di torte, dolciumi, confetteria;Piccola;7;106;90;16;4;7
47250;Commercio al dettaglio di bevande;Micro;79;163;56;107;2;0
47250;Commercio al dettaglio di bevande;Piccola;1;24;23;1;1;0
47260;Commercio al dettaglio di generi di monopolio (tabaccherie);Micro;429;843;231;612;20;0
47260;Commercio al dettaglio di generi di monopolio (tabaccherie);Piccola;1;11;8;3;0;0
47291;Commercio al dettaglio di latte e di prodotti lattiero-caseari;Micro;74;154;48;106;1;0
47292;Commercio al dettaglio di caffè torrefatto;Micro;9;24;13;11;3;0
47293;Commercio al dettaglio di prodotti macrobiotici e dietetici;Micro;8;9;1;8;2;0
47299;Commercio al dettaglio di altri prodotti alimentari in esercizi specializzati nca;Grande;1;346;346;0;3;17
47299;Commercio al dettaglio di altri prodotti alimentari in esercizi specializzati nca;Media;1;138;137;1;4;1
47299;Commercio al dettaglio di altri prodotti alimentari in esercizi specializzati nca;Micro;193;438;160;278;10;0
47299;Commercio al dettaglio di altri prodotti alimentari in esercizi specializzati nca;Piccola;10;170;156;14;4;0
47300;Commercio al dettaglio di carburante per autotrazione;Micro;230;578;251;327;8;0
47300;Commercio al dettaglio di carburante per autotrazione;Piccola;13;168;148;20;0;0
47410;Commercio al dettaglio di computer, unità periferiche, software e attrezzature per ufficio in esercizi specializzati;Grande;2;1615;1615;0;1;0
47410;Commercio al dettaglio di computer, unità periferiche, software e attrezzature per ufficio in esercizi specializzati;Micro;74;128;51;77;14;0
47410;Commercio al dettaglio di computer, unità periferiche, software e attrezzature per ufficio in esercizi specializzati;Piccola;4;75;69;6;0;0
47420;Commercio al dettaglio di apparecchiature per le telecomunicazioni e la telefonia in esercizi specializzati;Grande;1;770;770;0;1;0
47420;Commercio al dettaglio di apparecchiature per le telecomunicazioni e la telefonia in esercizi specializzati;Micro;159;366;191;175;12;0
47420;Commercio al dettaglio di apparecchiature per le telecomunicazioni e la telefonia in esercizi specializzati;Piccola;8;154;143;11;7;0
47430;Commercio al dettaglio di apparecchi audio e video in esercizi specializzati;Micro;44;105;48;57;6;0
47430;Commercio al dettaglio di apparecchi audio e video in esercizi specializzati;Piccola;4;45;40;5;3;0
47511;Commercio al dettaglio di tessuti per l'abbigliamento, l'arredamento e di biancheria per la casa;Micro;134;272;112;160;18;1
47511;Commercio al dettaglio di tessuti per l'abbigliamento, l'arredamento e di biancheria per la casa;Piccola;4;70;62;8;3;0
47512;Commercio al dettaglio di filati per maglieria e merceria;Micro;69;109;21;88;0;0
47512;Commercio al dettaglio di filati per maglieria e merceria;Piccola;1;34;33;1;2;0
47521;Commercio al dettaglio di ferramenta, vernici, vetro piano e materiale elettrico e termoidraulico;Grande;1;579;579;0;3;0
47521;Commercio al dettaglio di ferramenta, vernici, vetro piano e materiale elettrico e termoidraulico;Micro;261;504;117;387;13;0
47521;Commercio al dettaglio di ferramenta, vernici, vetro piano e materiale elettrico e termoidraulico;Piccola;2;23;22;1;0;0
47522;Commercio al dettaglio di articoli igienico-sanitari;Micro;26;51;23;28;3;0
47523;Commercio al dettaglio di materiali da costruzione, ceramiche e piastrelle;Micro;43;110;59;51;3;0
47523;Commercio al dettaglio di materiali da costruzione, ceramiche e piastrelle;Piccola;2;42;39;3;0;0
47524;Commercio al dettaglio di macchine, attrezzature e prodotti per l'agricoltura| macchine e attrezzature per il giardinaggio;Media;1;145;142;3;3;0
47524;Commercio al dettaglio di macchine, attrezzature e prodotti per l'agricoltura| macchine e attrezzature per il giardinaggio;Micro;4;5;1;4;0;0
47531;Commercio al dettaglio di tappeti, tende e tendine;Micro;65;136;64;72;7;93
47532;Commercio al dettaglio di carta da parati e rivestimenti per pavimenti (moquette e linoleum);Micro;11;19;7;12;4;0
47540;Commercio al dettaglio di elettrodomestici in esercizi specializzati;Grande;1;466;465;1;722;12
47540;Commercio al dettaglio di elettrodomestici in esercizi specializzati;Micro;73;167;51;116;3;0
47591;Commercio al dettaglio di mobili per la casa;Micro;276;667;323;344;28;1
47591;Commercio al dettaglio di mobili per la casa;Piccola;13;217;202;15;10;1
47592;Commercio al dettaglio di utensili per la casa, di cristallerie e vasellame;Media;1;215;215;0;0;2
47592;Commercio al dettaglio di utensili per la casa, di cristallerie e vasellame;Micro;120;263;113;150;14;0
47592;Commercio al dettaglio di utensili per la casa, di cristallerie e vasellame;Piccola;2;27;25;2;0;0
47593;Commercio al dettaglio di articoli per l'illuminazione;Micro;37;76;29;47;0;0
47593;Commercio al dettaglio di articoli per l'illuminazione;Piccola;1;21;20;1;0;0
47594;Commercio al dettaglio di macchine per cucire e per maglieria per uso domestico;Micro;13;23;6;17;1;0
47595;Commercio al dettaglio di sistemi di sicurezza;Micro;5;24;15;9;0;0
47596;Commercio al dettaglio di strumenti musicali e spartiti;Micro;27;68;33;35;5;0
47596;Commercio al dettaglio di strumenti musicali e spartiti;Piccola;1;17;15;2;5;0
47599;Commercio al dettaglio di altri articoli diversi per uso domestico nca;Media;1;100;97;3;2;0
47599;Commercio al dettaglio di altri articoli diversi per uso domestico nca;Micro;98;178;64;114;3;0
47599;Commercio al dettaglio di altri articoli diversi per uso domestico nca;Piccola;2;28;17;11;0;0
47610;Commercio al dettaglio di libri nuovi in esercizi specializzati;Grande;2;2015;2015;0;21;181
47610;Commercio al dettaglio di libri nuovi in esercizi specializzati;Media;2;270;270;0;6;0
47610;Commercio al dettaglio di libri nuovi in esercizi specializzati;Micro;97;237;123;114;20;0
47610;Commercio al dettaglio di libri nuovi in esercizi specializzati;Piccola;12;206;194;12;15;4
47621;Commercio al dettaglio di giornali, riviste e periodici;Micro;451;678;60;618;162;0
47621;Commercio al dettaglio di giornali, riviste e periodici;Piccola;4;96;85;11;3;0
47622;Commercio al dettaglio di articoli di cartoleria e forniture per ufficio;Micro;342;571;145;426;11;1
47622;Commercio al dettaglio di articoli di cartoleria e forniture per ufficio;Piccola;3;37;33;4;0;0
47630;Commercio al dettaglio di registrazioni musicali e video in esercizi specializzati;Micro;36;78;34;44;1;0
47641;Commercio al dettaglio di articoli sportivi, biciclette e articoli per il tempo libero;Grande;1;1324;1324;0;0;1
47641;Commercio al dettaglio di articoli sportivi, biciclette e articoli per il tempo libero;Media;2;141;134;7;48;0
47641;Commercio al dettaglio di articoli sportivi, biciclette e articoli per il tempo libero;Micro;164;316;113;203;12;0
47641;Commercio al dettaglio di articoli sportivi, biciclette e articoli per il tempo libero;Piccola;11;209;196;13;1;0
47642;Commercio al dettaglio di natanti e accessori;Micro;24;67;45;22;3;0
47650;Commercio al dettaglio di giochi e giocattoli (inclusi quelli elettronici);Grande;1;340;340;0;0;0
47650;Commercio al dettaglio di giochi e giocattoli (inclusi quelli elettronici);Media;2;133;130;3;53;1
47650;Commercio al dettaglio di giochi e giocattoli (inclusi quelli elettronici);Micro;79;147;51;96;9;0
47650;Commercio al dettaglio di giochi e giocattoli (inclusi quelli elettronici);Piccola;8;182;181;1;8;0
47711;Commercio al dettaglio di confezioni per adulti;Grande;13;11560;11560;0;1;180
47711;Commercio al dettaglio di confezioni per adulti;Media;18;1993;1988;5;20;18
47711;Commercio al dettaglio di confezioni per adulti;Micro;1183;2438;1125;1313;112;19
47711;Commercio al dettaglio di confezioni per adulti;Piccola;100;1962;1858;104;82;9
47712;Commercio al dettaglio di confezioni per bambini e neonati;Grande;1;771;771;0;2;1
47712;Commercio al dettaglio di confezioni per bambini e neonati;Media;2;368;368;0;0;5
47712;Commercio al dettaglio di confezioni per bambini e neonati;Micro;98;189;91;98;9;0
47712;Commercio al dettaglio di confezioni per bambini e neonati;Piccola;6;117;116;1;3;0
47713;Commercio al dettaglio di biancheria personale, maglieria, camicie;Grande;1;294;294;0;0;0
47713;Commercio al dettaglio di biancheria personale, maglieria, camicie;Micro;222;396;137;259;21;0
47713;Commercio al dettaglio di biancheria personale, maglieria, camicie;Piccola;8;141;131;10;10;0
47714;Commercio al dettaglio di pellicce e di abbigliamento in pelle;Micro;17;36;19;17;1;0
47714;Commercio al dettaglio di pellicce e di abbigliamento in pelle;Piccola;1;13;11;2;0;0
47715;Commercio al dettaglio di cappelli, ombrelli, guanti e cravatte;Media;1;139;139;0;0;0
47715;Commercio al dettaglio di cappelli, ombrelli, guanti e cravatte;Micro;12;27;14;13;0;0
47715;Commercio al dettaglio di cappelli, ombrelli, guanti e cravatte;Piccola;1;11;9;2;1;0
47721;Commercio al dettaglio di calzature e accessori;Media;5;465;463;2;0;1
47721;Commercio al dettaglio di calzature e accessori;Micro;306;737;331;406;14;0
47721;Commercio al dettaglio di calzature e accessori;Piccola;19;386;358;28;7;1
47722;Commercio al dettaglio di articoli di pelletteria e da viaggio;Media;1;95;95;0;0;7
47722;Commercio al dettaglio di articoli di pelletteria e da viaggio;Micro;111;208;65;143;3;0
47722;Commercio al dettaglio di articoli di pelletteria e da viaggio;Piccola;9;167;158;9;11;9
47731;Farmacie;Grande;1;355;355;0;3;1
47731;Farmacie;Media;1;66;66;0;1;0
47731;Farmacie;Micro;332;1454;1032;422;15;4
47731;Farmacie;Piccola;22;313;281;32;6;0
47732;Commercio al dettaglio in altri esercizi specializzati di medicinali non soggetti a prescrizione medica;Media;1;147;147;0;1;0
47732;Commercio al dettaglio in altri esercizi specializzati di medicinali non soggetti a prescrizione medica;Micro;11;24;13;11;2;0
47740;Commercio al dettaglio di articoli medicali e ortopedici in esercizi specializzati;Grande;1;447;447;0;31;8
47740;Commercio al dettaglio di articoli medicali e ortopedici in esercizi specializzati;Micro;56;123;49;74;2;1
47740;Commercio al dettaglio di articoli medicali e ortopedici in esercizi specializzati;Piccola;7;111;99;12;9;0
47751;Commercio al dettaglio di articoli di profumeria, prodotti per toletta e per l'igiene personale;Grande;2;2588;2588;0;3;138
47751;Commercio al dettaglio di articoli di profumeria, prodotti per toletta e per l'igiene personale;Media;4;541;541;0;6;5
47751;Commercio al dettaglio di articoli di profumeria, prodotti per toletta e per l'igiene personale;Micro;163;379;190;189;18;0
47751;Commercio al dettaglio di articoli di profumeria, prodotti per toletta e per l'igiene personale;Piccola;9;191;183;8;3;0
47752;Erboristerie;Micro;108;184;46;138;5;0
47752;Erboristerie;Piccola;2;33;31;2;4;0
47761;Commercio al dettaglio di fiori e piante;Media;1;99;99;0;0;0
47761;Commercio al dettaglio di fiori e piante;Micro;157;280;74;206;8;0
47761;Commercio al dettaglio di fiori e piante;Piccola;8;176;165;11;8;0
47762;Commercio al dettaglio di piccoli animali domestici;Micro;99;140;16;124;8;0
47770;Commercio al dettaglio di orologi, articoli di gioielleria e argenteria;Media;4;486;486;0;10;18
47770;Commercio al dettaglio di orologi, articoli di gioielleria e argenteria;Micro;507;995;329;666;47;1
47770;Commercio al dettaglio di orologi, articoli di gioielleria e argenteria;Piccola;24;469;440;29;20;1
47781;Commercio al dettaglio di mobili per ufficio;Micro;3;6;2;4;0;0
47781;Commercio al dettaglio di mobili per ufficio;Piccola;1;14;12;2;0;0
47782;Commercio al dettaglio di materiale per ottica e fotografia;Grande;2;1677;1677;0;6;0
47782;Commercio al dettaglio di materiale per ottica e fotografia;Media;1;118;118;0;0;0
47782;Commercio al dettaglio di materiale per ottica e fotografia;Micro;309;650;238;412;21;0
47782;Commercio al dettaglio di materiale per ottica e fotografia;Piccola;11;155;141;14;4;0
47783;Commercio al dettaglio di oggetti d'arte di culto e di decorazione, chincaglieria e bigiotteria;Grande;1;665;665;0;0;0
47783;Commercio al dettaglio di oggetti d'arte di culto e di decorazione, chincaglieria e bigiotteria;Micro;390;634;217;417;91;0
47783;Commercio al dettaglio di oggetti d'arte di culto e di decorazione, chincaglieria e bigiotteria;Piccola;11;212;202;10;7;0
47784;Commercio al dettaglio di combustibile per uso domestico e per riscaldamento;Micro;9;37;25;12;2;0
47784;Commercio al dettaglio di combustibile per uso domestico e per riscaldamento;Piccola;1;11;11;0;1;0
47785;Commercio al dettaglio di armi e munizioni, articoli militari;Micro;9;21;6;15;0;0
47786;Commercio al dettaglio di saponi, detersivi, prodotti per la lucidatura e affini;Micro;14;27;12;15;0;0
47789;Commercio al dettaglio di altri prodotti non alimentari;Media;3;276;276;0;0;5
47789;Commercio al dettaglio di altri prodotti non alimentari;Micro;363;648;228;420;37;0
47789;Commercio al dettaglio di altri prodotti non alimentari;Piccola;7;102;91;11;5;0
47791;Commercio al dettaglio di libri di seconda mano;Micro;26;35;5;30;1;0
47792;Commercio al dettaglio di mobili usati e oggetti di antiquariato;Micro;187;278;60;218;21;0
47792;Commercio al dettaglio di mobili usati e oggetti di antiquariato;Piccola;1;41;40;1;11;0
47793;Commercio al dettaglio di indumenti e altri oggetti usati;Micro;46;70;17;53;12;0
47794;Case d'asta al dettaglio (escluse aste via internet);Micro;19;29;20;9;3;0
47794;Case d'asta al dettaglio (escluse aste via internet);Piccola;5;107;106;1;5;1
47810;Commercio al dettaglio ambulante di prodotti alimentari e bevande;Micro;342;596;113;483;0;0
47820;Commercio al dettaglio ambulante di prodotti tessili, abbigliamento, calzature e pelletterie;Micro;657;815;65;750;5;0
47890;Commercio al dettaglio ambulante di altri prodotti;Micro;649;755;55;700;1;0
47890;Commercio al dettaglio ambulante di altri prodotti;Piccola;1;14;13;1;0;0
47911;Commercio al dettaglio di qualsiasi tipo di prodotto effettuato via internet;Media;4;350;350;0;4;10
47911;Commercio al dettaglio di qualsiasi tipo di prodotto effettuato via internet;Micro;214;253;74;179;33;0
47911;Commercio al dettaglio di qualsiasi tipo di prodotto effettuato via internet;Piccola;7;130;127;3;41;2
47912;Commercio al dettaglio di qualsiasi tipo di prodotto effettuato per televisione;Micro;7;0;0;0;3;0
47912;Commercio al dettaglio di qualsiasi tipo di prodotto effettuato per televisione;Piccola;1;25;25;0;1;1
47913;Commercio al dettaglio di qualsiasi tipo di prodotto per corrispondenza, radio, telefono;Micro;69;136;75;61;198;0
47913;Commercio al dettaglio di qualsiasi tipo di prodotto per corrispondenza, radio, telefono;Piccola;7;93;88;5;9;0
47991;Commercio al dettaglio di prodotti vari, mediante l'intervento di un dimostratore o di un incaricato alla vendita (porta a porta);Media;1;56;56;0;2;1
47991;Commercio al dettaglio di prodotti vari, mediante l'intervento di un dimostratore o di un incaricato alla vendita (porta a porta);Micro;48;90;41;49;29;0
47991;Commercio al dettaglio di prodotti vari, mediante l'intervento di un dimostratore o di un incaricato alla vendita (porta a porta);Piccola;2;40;35;5;3;0
47992;Commercio effettuato per mezzo di distributori automatici;Media;2;160;155;5;3;1
47992;Commercio effettuato per mezzo di distributori automatici;Micro;72;141;69;72;15;0
49100;Trasporto ferroviario di passeggeri (interurbano);Piccola;1;19;19;0;1;0
49200;Trasporto ferroviario di merci;Media;1;128;128;0;20;0
49200;Trasporto ferroviario di merci;Micro;1;1;1;0;0;0
49310;Trasporto terrestre di passeggeri in aree urbane e suburbane;Grande;5;13655;13655;0;59;35
49310;Trasporto terrestre di passeggeri in aree urbane e suburbane;Media;2;281;278;3;9;0
49310;Trasporto terrestre di passeggeri in aree urbane e suburbane;Micro;19;28;16;12;6;0
49310;Trasporto terrestre di passeggeri in aree urbane e suburbane;Piccola;1;19;19;0;2;0
49321;Trasporto con taxi;Media;2;154;154;0;0;0
49321;Trasporto con taxi;Micro;2064;2189;9;2180;0;0
49321;Trasporto con taxi;Piccola;1;44;44;0;0;0
49322;Trasporto mediante noleggio di autovetture da rimessa con conducente;Micro;120;179;53;126;21;0
49322;Trasporto mediante noleggio di autovetture da rimessa con conducente;Piccola;4;47;46;1;0;0
49390;Altri trasporti terrestri di passeggeri nca;Media;2;103;102;1;4;0
49390;Altri trasporti terrestri di passeggeri nca;Micro;38;57;22;35;28;0
49390;Altri trasporti terrestri di passeggeri nca;Piccola;7;138;103;35;5;0
49410;Trasporto di merci su strada;Grande;1;334;334;0;4;0
49410;Trasporto di merci su strada;Media;18;1643;1591;52;13;1
49410;Trasporto di merci su strada;Micro;921;1992;1055;937;112;0
49410;Trasporto di merci su strada;Piccola;158;3191;3025;166;84;12
49420;Servizi di trasloco;Micro;62;162;91;71;3;0
49420;Servizi di trasloco;Piccola;6;78;66;12;1;0
49501;Trasporto mediante condotte di gas;Micro;3;1;1;0;1;0
49502;Trasporto mediante condotte di liquidi;Media;1;84;84;0;0;0
50100;Trasporto marittimo e costiero di passeggeri;Grande;1;1021;1021;0;4;2
50100;Trasporto marittimo e costiero di passeggeri;Micro;10;27;26;1;1;0
50100;Trasporto marittimo e costiero di passeggeri;Piccola;1;12;12;0;1;0
50200;Trasporto marittimo e costiero di merci;Micro;2;6;5;1;7;0
50200;Trasporto marittimo e costiero di merci;Piccola;7;184;182;2;10;0
50300;Trasporto di passeggeri per vie d'acqua interne (inclusi i trasporti lagunari);Micro;1;0;0;0;0;0
51101;Trasporto aereo di linea di passeggeri;Media;3;306;306;0;0;0
51101;Trasporto aereo di linea di passeggeri;Micro;9;23;23;0;0;0
51101;Trasporto aereo di linea di passeggeri;Piccola;8;175;175;0;1;0
51102;Trasporto aereo non di linea di passeggeri| voli charter;Media;1;83;82;1;2;0
51102;Trasporto aereo non di linea di passeggeri| voli charter;Micro;4;10;10;0;1;0
51102;Trasporto aereo non di linea di passeggeri| voli charter;Piccola;8;208;207;1;16;0
51210;Trasporto aereo di merci;Media;1;83;83;0;1;0
51210;Trasporto aereo di merci;Micro;4;16;16;0;2;0
52101;Magazzini di custodia e deposito per conto terzi;Grande;1;254;254;0;0;0
52101;Magazzini di custodia e deposito per conto terzi;Media;9;783;712;71;3;0
52101;Magazzini di custodia e deposito per conto terzi;Micro;88;203;150;53;20;3
52101;Magazzini di custodia e deposito per conto terzi;Piccola;20;417;404;13;12;5
52102;Magazzini frigoriferi per conto terzi;Micro;4;12;10;2;1;0
52102;Magazzini frigoriferi per conto terzi;Piccola;1;35;35;0;1;0
52211;Gestione di infrastrutture ferroviarie;Grande;1;895;895;0;7;0
52211;Gestione di infrastrutture ferroviarie;Media;1;198;198;0;0;0
52211;Gestione di infrastrutture ferroviarie;Micro;3;7;5;2;7;0
52211;Gestione di infrastrutture ferroviarie;Piccola;1;31;31;0;0;0
52212;Gestione di strade, ponti, gallerie;Micro;1;0;0;0;3;0
52215;Gestione di parcheggi e autorimesse;Media;2;191;188;3;3;0
52215;Gestione di parcheggi e autorimesse;Micro;296;754;496;258;36;12
52215;Gestione di parcheggi e autorimesse;Piccola;16;240;219;21;11;0
52216;Attività di traino e soccorso stradale;Grande;1;284;284;0;0;0
52216;Attività di traino e soccorso stradale;Micro;28;46;13;33;2;0
52219;Altre attività connesse ai trasporti terrestri nca;Media;8;588;584;4;4;0
52219;Altre attività connesse ai trasporti terrestri nca;Micro;109;216;147;69;67;0
52219;Altre attività connesse ai trasporti terrestri nca;Piccola;20;370;358;12;8;5
52220;Attività dei servizi connessi al trasporto marittimo e per vie d'acqua;Media;1;104;104;0;0;0
52220;Attività dei servizi connessi al trasporto marittimo e per vie d'acqua;Micro;25;27;20;7;6;0
52220;Attività dei servizi connessi al trasporto marittimo e per vie d'acqua;Piccola;7;146;145;1;15;0
52230;Attività dei servizi connessi al trasporto aereo;Grande;1;702;702;0;3;0
52230;Attività dei servizi connessi al trasporto aereo;Media;2;110;110;0;1;0
52230;Attività dei servizi connessi al trasporto aereo;Micro;33;43;33;10;30;0
52230;Attività dei servizi connessi al trasporto aereo;Piccola;7;120;116;4;8;0
52241;Movimento merci relativo a trasporti aerei;Micro;5;22;19;3;2;0
52241;Movimento merci relativo a trasporti aerei;Piccola;1;26;25;1;1;0
52242;Movimento merci relativo a trasporti marittimi e fluviali;Micro;1;4;3;1;0;0
52243;Movimento merci relativo a trasporti ferroviari;Media;1;72;72;0;0;1
52243;Movimento merci relativo a trasporti ferroviari;Micro;6;11;7;4;1;0
52243;Movimento merci relativo a trasporti ferroviari;Piccola;1;16;16;0;0;0
52244;Movimento merci relativo ad altri trasporti terrestri;Grande;7;4355;4354;1;5;0
52244;Movimento merci relativo ad altri trasporti terrestri;Media;66;7466;6895;571;26;59
52244;Movimento merci relativo ad altri trasporti terrestri;Micro;180;226;170;56;20;0
52244;Movimento merci relativo ad altri trasporti terrestri;Piccola;64;1710;1661;49;37;4
52291;Spedizionieri e agenzie di operazioni doganali;Grande;2;1810;1810;0;12;5
52291;Spedizionieri e agenzie di operazioni doganali;Media;4;238;237;1;15;0
52291;Spedizionieri e agenzie di operazioni doganali;Micro;98;222;144;78;25;0
52291;Spedizionieri e agenzie di operazioni doganali;Piccola;29;616;587;29;62;9
52292;Intermediari dei trasporti, servizi logistici;Grande;3;1250;1249;1;1;0
52292;Intermediari dei trasporti, servizi logistici;Media;42;4536;4521;15;23;150
52292;Intermediari dei trasporti, servizi logistici;Micro;332;798;571;227;101;3
52292;Intermediari dei trasporti, servizi logistici;Piccola;108;2156;2093;63;65;3
53200;Altre attività postali e di corriere senza obbligo di servizio universale;Grande;2;1248;1248;0;5;44
53200;Altre attività postali e di corriere senza obbligo di servizio universale;Media;4;363;363;0;244;5
53200;Altre attività postali e di corriere senza obbligo di servizio universale;Micro;97;155;59;96;5;0
53200;Altre attività postali e di corriere senza obbligo di servizio universale;Piccola;8;194;189;5;7;0
55100;Alberghi;Grande;8;4423;4420;3;9;194
55100;Alberghi;Media;20;2395;2393;2;15;79
55100;Alberghi;Micro;350;1210;879;331;33;24
55100;Alberghi;Piccola;164;3007;2873;134;68;61
55201;Villaggi turistici;Grande;1;385;385;0;55;1
55201;Villaggi turistici;Media;2;139;139;0;2;0
55201;Villaggi turistici;Micro;8;22;21;1;1;0
55201;Villaggi turistici;Piccola;1;14;13;1;1;0
55202;Ostelli della gioventù;Micro;2;5;1;4;6;0
55204;Colonie marine e montane;Media;1;60;60;0;1;0
55204;Colonie marine e montane;Micro;3;9;8;1;1;0
55205;Affittacamere per brevi soggiorni, case ed appartamenti per vacanze, bed and breakfast, residence, alloggio connesso alle aziende agricole;Media;1;67;67;0;0;0
55205;Affittacamere per brevi soggiorni, case ed appartamenti per vacanze, bed and breakfast, residence, alloggio connesso alle aziende agricole;Micro;147;269;166;103;20;0
55205;Affittacamere per brevi soggiorni, case ed appartamenti per vacanze, bed and breakfast, residence, alloggio connesso alle aziende agricole;Piccola;5;105;103;2;11;0
55300;Aree di campeggio e aree attrezzate per camper e roulotte;Micro;23;52;30;22;2;0
55902;Alloggi per studenti e lavoratori con servizi accessori di tipo alberghiero;Micro;11;29;22;7;2;3
55902;Alloggi per studenti e lavoratori con servizi accessori di tipo alberghiero;Piccola;2;28;27;1;0;0
56101;Ristorazione con somministrazione| ristorazione connessa alle aziende agricole;Grande;3;1765;1764;1;12;19
56101;Ristorazione con somministrazione| ristorazione connessa alle aziende agricole;Media;11;911;900;11;5;50
56101;Ristorazione con somministrazione| ristorazione connessa alle aziende agricole;Micro;2346;9494;6244;3250;133;8
56101;Ristorazione con somministrazione| ristorazione connessa alle aziende agricole;Piccola;504;7885;7187;698;136;21
56102;Ristorazione senza somministrazione con preparazione di cibi da asporto;Media;1;53;52;1;0;0
56102;Ristorazione senza somministrazione con preparazione di cibi da asporto;Micro;467;1061;443;618;13;0
56102;Ristorazione senza somministrazione con preparazione di cibi da asporto;Piccola;11;166;146;20;1;0
56103;Gelaterie e pasticcerie;Micro;279;699;311;388;14;0
56103;Gelaterie e pasticcerie;Piccola;13;210;185;25;0;4
56104;Ristorazione ambulante e gelaterie ambulanti;Micro;4;7;4;3;1;0
56105;Ristorazione su treni e navi;Media;1;85;83;2;4;0
56210;Catering per eventi, banqueting;Media;1;87;86;1;0;0
56210;Catering per eventi, banqueting;Micro;111;169;65;104;26;0
56210;Catering per eventi, banqueting;Piccola;9;172;164;8;4;5
56291;Mense;Grande;5;25114;25112;2;42;381
56291;Mense;Media;2;130;130;0;1;0
56291;Mense;Micro;24;56;32;24;3;0
56291;Mense;Piccola;14;262;246;16;1;0
56292;Catering continuativo su base contrattuale;Grande;2;930;929;1;7;41
56292;Catering continuativo su base contrattuale;Media;1;88;88;0;0;0
56292;Catering continuativo su base contrattuale;Micro;7;21;18;3;2;0
56292;Catering continuativo su base contrattuale;Piccola;3;62;59;3;1;0
56300;Bar e altri esercizi simili senza cucina;Media;2;163;162;1;0;0
56300;Bar e altri esercizi simili senza cucina;Micro;3194;8519;3793;4726;91;10
56300;Bar e altri esercizi simili senza cucina;Piccola;101;1517;1362;155;20;4
58110;Edizione di libri;Media;7;1055;1052;3;346;25
58110;Edizione di libri;Micro;237;433;256;177;165;0
58110;Edizione di libri;Piccola;28;630;617;13;190;1
58120;Pubblicazione di elenchi e mailing list;Piccola;1;26;26;0;0;0
58130;Edizione di quotidiani;Grande;2;2424;2424;0;42;77
58130;Edizione di quotidiani;Media;3;434;434;0;13;1
58130;Edizione di quotidiani;Micro;19;38;34;4;19;0
58130;Edizione di quotidiani;Piccola;5;93;90;3;14;0
58140;Edizione di riviste e periodici;Grande;3;1189;1189;0;97;9
58140;Edizione di riviste e periodici;Media;12;1253;1252;1;102;12
58140;Edizione di riviste e periodici;Micro;438;942;671;271;334;3
58140;Edizione di riviste e periodici;Piccola;59;1070;1028;42;243;2
58190;Altre attività editoriali;Media;1;128;128;0;72;0
58190;Altre attività editoriali;Micro;115;158;93;65;56;1
58190;Altre attività editoriali;Piccola;10;207;201;6;29;1
58210;Edizione di giochi per computer;Piccola;1;14;14;0;20;0
58290;Edizione di altri software a pacchetto (esclusi giochi per computer);Micro;37;60;33;27;6;0
58290;Edizione di altri software a pacchetto (esclusi giochi per computer);Piccola;5;171;169;2;4;0
59110;Attività di produzione cinematografica, di video e di programmi televisivi;Grande;1;283;283;0;5;0
59110;Attività di produzione cinematografica, di video e di programmi televisivi;Media;7;608;602;6;101;0
59110;Attività di produzione cinematografica, di video e di programmi televisivi;Micro;484;675;263;412;123;0
59110;Attività di produzione cinematografica, di video e di programmi televisivi;Piccola;23;408;393;15;82;3
59120;Attività di post-produzione cinematografica, di video e di programmi televisivi;Media;2;132;131;1;2;0
59120;Attività di post-produzione cinematografica, di video e di programmi televisivi;Micro;105;177;74;103;30;0
59120;Attività di post-produzione cinematografica, di video e di programmi televisivi;Piccola;13;215;187;28;12;0
59130;Attività di distribuzione cinematografica, di video e di programmi televisivi;Micro;25;46;39;7;3;0
59130;Attività di distribuzione cinematografica, di video e di programmi televisivi;Piccola;6;134;134;0;8;0
59140;Attività di proiezione cinematografica;Micro;15;52;41;11;0;0
59140;Attività di proiezione cinematografica;Piccola;8;123;114;9;7;0
59201;Edizione di registrazioni sonore;Media;2;121;121;0;3;2
59201;Edizione di registrazioni sonore;Micro;130;144;48;96;12;0
59201;Edizione di registrazioni sonore;Piccola;4;111;111;0;8;0
59202;Edizione di musica stampata;Micro;12;8;0;8;1;0
59203;Studi di registrazione sonora;Micro;27;29;1;28;3;0
60100;Trasmissioni radiofoniche;Media;3;224;224;0;6;7
60100;Trasmissioni radiofoniche;Micro;42;96;63;33;7;0
60100;Trasmissioni radiofoniche;Piccola;7;148;147;1;4;4
60200;Programmazione e trasmissioni televisive;Grande;2;2820;2820;0;1176;144
60200;Programmazione e trasmissioni televisive;Media;4;678;677;1;64;17
60200;Programmazione e trasmissioni televisive;Micro;39;57;38;19;5;0
60200;Programmazione e trasmissioni televisive;Piccola;9;206;205;1;2;3
61100;Telecomunicazioni fisse;Grande;2;4357;4357;0;2;49
61100;Telecomunicazioni fisse;Media;1;190;190;0;1;0
61100;Telecomunicazioni fisse;Micro;26;31;20;11;25;0
61100;Telecomunicazioni fisse;Piccola;4;59;56;3;2;1
61200;Telecomunicazioni mobili;Media;1;80;80;0;17;0
61200;Telecomunicazioni mobili;Micro;5;7;5;2;2;0
61200;Telecomunicazioni mobili;Piccola;1;20;20;0;1;0
61300;Telecomunicazioni satellitari;Micro;1;3;2;1;0;0
61300;Telecomunicazioni satellitari;Piccola;2;24;23;1;1;0
61901;Erogazione di servizi di accesso ad internet (ISP);Media;2;123;122;1;8;0
61901;Erogazione di servizi di accesso ad internet (ISP);Micro;5;5;3;2;1;0
61901;Erogazione di servizi di accesso ad internet (ISP);Piccola;3;37;37;0;1;0
61902;Posto telefonico pubblico ed Internet Point;Micro;63;87;24;63;0;0
61909;Altre attività connesse alle telecomunicazioni;Media;4;369;368;1;8;2
61909;Altre attività connesse alle telecomunicazioni;Micro;189;309;185;124;162;1
61909;Altre attività connesse alle telecomunicazioni;Piccola;16;292;285;7;22;3
62010;Produzione di software non connesso all'edizione;Grande;9;5958;5955;3;187;240
62010;Produzione di software non connesso all'edizione;Media;41;4271;4251;20;402;18
62010;Produzione di software non connesso all'edizione;Micro;1196;2209;1070;1139;582;1
62010;Produzione di software non connesso all'edizione;Piccola;152;2850;2692;158;477;12
62020;Consulenza nel settore delle tecnologie dell'informatica;Grande;8;4851;4848;3;145;38
62020;Consulenza nel settore delle tecnologie dell'informatica;Media;16;1426;1409;17;95;0
62020;Consulenza nel settore delle tecnologie dell'informatica;Micro;1400;2039;725;1314;248;3
62020;Consulenza nel settore delle tecnologie dell'informatica;Piccola;73;1417;1343;74;275;5
62030;Gestione di strutture e apparecchiature informatiche hardware - housing (esclusa la riparazione);Media;6;403;401;2;50;0
62030;Gestione di strutture e apparecchiature informatiche hardware - housing (esclusa la riparazione);Micro;143;314;189;125;91;0
62030;Gestione di strutture e apparecchiature informatiche hardware - housing (esclusa la riparazione);Piccola;40;768;742;26;171;1
62090;Altre attività dei servizi connessi alle tecnologie dell'informatica;Grande;1;283;283;0;0;6
62090;Altre attività dei servizi connessi alle tecnologie dell'informatica;Media;12;997;992;5;62;4
62090;Altre attività dei servizi connessi alle tecnologie dell'informatica;Micro;773;1188;571;617;318;4
62090;Altre attività dei servizi connessi alle tecnologie dell'informatica;Piccola;64;1239;1206;33;140;1
63111;Elaborazione dati;Grande;6;2672;2670;2;38;48
63111;Elaborazione dati;Media;14;1540;1535;5;38;4
63111;Elaborazione dati;Micro;1387;3192;2184;1008;241;13
63111;Elaborazione dati;Piccola;94;1611;1563;48;311;11
63112;Gestione database (attività delle banche dati);Media;3;311;311;0;4;0
63112;Gestione database (attività delle banche dati);Micro;53;89;61;28;37;1
63112;Gestione database (attività delle banche dati);Piccola;13;257;251;6;67;6
63113;Hosting e fornitura di servizi applicativi (ASP);Media;1;190;190;0;3;0
63113;Hosting e fornitura di servizi applicativi (ASP);Micro;73;158;101;57;57;1
63113;Hosting e fornitura di servizi applicativi (ASP);Piccola;11;138;122;16;9;5
63120;Portali web;Grande;1;340;340;0;0;0
63120;Portali web;Media;4;380;380;0;9;45
63120;Portali web;Micro;124;199;88;111;102;0
63120;Portali web;Piccola;8;112;110;2;90;0
63910;Attività delle agenzie di stampa;Micro;68;114;48;66;20;0
63910;Attività delle agenzie di stampa;Piccola;8;164;161;3;11;0
63990;Altre attività dei servizi di informazione nca;Micro;192;260;123;137;90;0
63990;Altre attività dei servizi di informazione nca;Piccola;11;168;162;6;132;0
64191;Intermediazione monetaria di istituti monetari diverse dalle Banche centrali;Grande;28;27524;27519;5;158;124
64191;Intermediazione monetaria di istituti monetari diverse dalle Banche centrali;Media;31;3586;3586;0;81;85
64191;Intermediazione monetaria di istituti monetari diverse dalle Banche centrali;Micro;14;44;44;0;2;2
64191;Intermediazione monetaria di istituti monetari diverse dalle Banche centrali;Piccola;24;641;632;9;41;4
64193;Istituti di moneta elettronica (Imel);Piccola;1;13;13;0;1;0
64200;Attività delle società di partecipazione (holding);Media;1;58;58;0;3;1
64200;Attività delle società di partecipazione (holding);Micro;639;205;91;114;219;1
64200;Attività delle società di partecipazione (holding);Piccola;3;94;94;0;1;1
64910;Leasing finanziario;Grande;4;1807;1807;0;10;9
64910;Leasing finanziario;Media;4;292;292;0;1;0
64910;Leasing finanziario;Micro;29;25;23;2;5;0
64910;Leasing finanziario;Piccola;7;168;168;0;7;0
64920;Altre attività creditizie;Grande;5;4525;4525;0;26;69
64920;Altre attività creditizie;Media;12;1335;1335;0;325;40
64920;Altre attività creditizie;Micro;49;81;71;10;29;0
64920;Altre attività creditizie;Piccola;24;529;505;24;62;0
64991;Attività di intermediazione mobiliare;Media;3;267;267;0;12;0
64991;Attività di intermediazione mobiliare;Micro;68;174;149;25;48;1
64991;Attività di intermediazione mobiliare;Piccola;30;627;615;12;43;5
64992;Attività di factoring;Grande;2;609;609;0;3;1
64992;Attività di factoring;Media;5;654;654;0;18;2
64992;Attività di factoring;Micro;13;27;27;0;17;0
64992;Attività di factoring;Piccola;9;219;218;1;18;0
64993;Attività di merchant bank;Micro;14;17;11;6;11;0
64993;Attività di merchant bank;Piccola;2;33;33;0;0;0
64994;Attività delle società veicolo;Micro;22;8;8;0;13;2
64994;Attività delle società veicolo;Piccola;2;31;31;0;3;0
64995;Attività di intermediazione in cambi;Micro;3;2;1;1;2;0
64995;Attività di intermediazione in cambi;Piccola;1;10;10;0;1;0
64996;Altre intermediazioni finanziarie nca;Grande;1;618;618;0;2;33
64996;Altre intermediazioni finanziarie nca;Media;5;432;431;1;3;2
64996;Altre intermediazioni finanziarie nca;Micro;286;274;217;57;98;2
64996;Altre intermediazioni finanziarie nca;Piccola;22;403;390;13;30;9
65110;Assicurazioni sulla vita;Media;10;1325;1325;0;16;35
65110;Assicurazioni sulla vita;Micro;17;69;69;0;8;1
65110;Assicurazioni sulla vita;Piccola;13;259;259;0;17;6
65120;Assicurazioni diverse da quelle sulla vita;Grande;10;7262;7262;0;65;158
65120;Assicurazioni diverse da quelle sulla vita;Media;15;1640;1640;0;16;21
65120;Assicurazioni diverse da quelle sulla vita;Micro;30;103;103;0;19;5
65120;Assicurazioni diverse da quelle sulla vita;Piccola;20;480;478;2;50;21
65200;Attività di riassicurazione;Media;1;100;100;0;0;0
65200;Attività di riassicurazione;Micro;1;8;8;0;0;0
65200;Attività di riassicurazione;Piccola;3;59;59;0;1;2
66110;Amministrazione di mercati finanziari;Media;2;310;310;0;8;0
66110;Amministrazione di mercati finanziari;Piccola;2;53;53;0;3;0
66120;Attività di negoziazione di contratti relativi a titoli e merci;Grande;1;266;264;2;1;0
66120;Attività di negoziazione di contratti relativi a titoli e merci;Micro;10;16;11;5;11;0
66120;Attività di negoziazione di contratti relativi a titoli e merci;Piccola;4;139;137;2;8;0
66191;Attività di gestione ed elaborazione di pagamenti tramite carta di credito;Micro;1;1;1;0;0;0
66192;Attività di promotori e mediatori finanziari;Micro;1151;1431;317;1114;107;0
66192;Attività di promotori e mediatori finanziari;Piccola;16;265;253;12;10;0
66193;Attività delle società fiduciarie di amministrazione;Media;2;266;266;0;9;6
66193;Attività delle società fiduciarie di amministrazione;Micro;64;120;113;7;29;2
66193;Attività delle società fiduciarie di amministrazione;Piccola;6;107;107;0;7;0
66195;Servizi di trasferimento di denaro (money transfer);Media;1;77;76;1;4;0
66195;Servizi di trasferimento di denaro (money transfer);Micro;23;40;17;23;1;0
66195;Servizi di trasferimento di denaro (money transfer);Piccola;2;55;54;1;13;0
66210;Attività dei periti e liquidatori indipendenti delle assicurazioni;Media;2;137;135;2;19;10
66210;Attività dei periti e liquidatori indipendenti delle assicurazioni;Micro;221;372;149;223;42;2
66210;Attività dei periti e liquidatori indipendenti delle assicurazioni;Piccola;9;123;114;9;11;0
66220;Attività degli agenti e broker delle assicurazioni;Grande;2;1721;1721;0;47;5
66220;Attività degli agenti e broker delle assicurazioni;Media;5;601;600;1;60;0
66220;Attività degli agenti e broker delle assicurazioni;Micro;1425;3054;1452;1602;250;4
66220;Attività degli agenti e broker delle assicurazioni;Piccola;85;1426;1304;122;140;9
66290;Altre attività ausiliarie delle assicurazioni e dei fondi pensione;Media;2;189;189;0;0;0
66290;Altre attività ausiliarie delle assicurazioni e dei fondi pensione;Micro;29;38;22;16;5;0
66290;Altre attività ausiliarie delle assicurazioni e dei fondi pensione;Piccola;2;57;57;0;4;0
66300;Gestione di fondi comuni di investimento e dei fondi pensione;Grande;2;697;697;0;5;4
66300;Gestione di fondi comuni di investimento e dei fondi pensione;Media;17;1549;1544;5;60;26
66300;Gestione di fondi comuni di investimento e dei fondi pensione;Micro;71;303;291;12;85;3
66300;Gestione di fondi comuni di investimento e dei fondi pensione;Piccola;38;637;630;7;105;5
68100;Compravendita di beni immobili effettuata su beni propri;Media;1;67;67;0;0;0
68100;Compravendita di beni immobili effettuata su beni propri;Micro;2882;1909;668;1241;320;0
68100;Compravendita di beni immobili effettuata su beni propri;Piccola;24;390;368;22;26;12
68200;Affitto e gestione di immobili di proprietà o in leasing;Media;2;230;230;0;10;3
68200;Affitto e gestione di immobili di proprietà o in leasing;Micro;11947;10507;2498;8009;942;10
68200;Affitto e gestione di immobili di proprietà o in leasing;Piccola;59;956;891;65;63;5
68310;Attività di mediazione immobiliare;Media;4;301;301;0;6;0
68310;Attività di mediazione immobiliare;Micro;1852;2724;691;2033;329;1
68310;Attività di mediazione immobiliare;Piccola;11;214;210;4;22;6
68320;Amministrazione di condomini e gestione di beni immobili per conto terzi;Media;4;265;265;0;7;5
68320;Amministrazione di condomini e gestione di beni immobili per conto terzi;Micro;790;1708;891;817;60;4
68320;Amministrazione di condomini e gestione di beni immobili per conto terzi;Piccola;22;396;380;16;20;0
69101;Attività degli studi legali;Media;8;682;491;191;21;9
69101;Attività degli studi legali;Micro;10931;14713;2729;11984;149;4
69101;Attività degli studi legali;Piccola;74;1449;920;529;19;10
69102;Attività degli studi notarili;Media;3;229;224;5;11;3
69102;Attività degli studi notarili;Micro;176;801;610;191;10;0
69102;Attività degli studi notarili;Piccola;55;816;718;98;29;1
69201;Attività degli studi commerciali, tributari e revisione contabile;Grande;2;614;500;114;6;0
69201;Attività degli studi commerciali, tributari e revisione contabile;Media;22;2269;1506;763;31;64
69201;Attività degli studi commerciali, tributari e revisione contabile;Micro;6471;11107;4136;6971;220;2
69201;Attività degli studi commerciali, tributari e revisione contabile;Piccola;119;1964;1574;390;1260;95
69202;Attività delle società di revisione e certificazione di bilanci;Grande;5;5443;5443;0;104;0
69202;Attività delle società di revisione e certificazione di bilanci;Media;3;328;327;1;13;0
69202;Attività delle società di revisione e certificazione di bilanci;Micro;4;28;27;1;11;0
69202;Attività delle società di revisione e certificazione di bilanci;Piccola;2;41;41;0;0;0
69203;Attività dei consulenti del lavoro;Micro;453;950;457;493;29;2
69203;Attività dei consulenti del lavoro;Piccola;18;277;247;30;11;0
70100;Attività delle holding impegnate nelle attività gestionali (holding operative);Grande;2;566;566;0;7;0
70100;Attività delle holding impegnate nelle attività gestionali (holding operative);Media;18;2290;2287;3;78;33
70100;Attività delle holding impegnate nelle attività gestionali (holding operative);Micro;363;807;708;99;201;2
70100;Attività delle holding impegnate nelle attività gestionali (holding operative);Piccola;72;1501;1480;21;162;13
70210;Pubbliche relazioni e comunicazione;Media;4;334;333;1;67;0
70210;Pubbliche relazioni e comunicazione;Micro;1332;1740;483;1257;382;2
70210;Pubbliche relazioni e comunicazione;Piccola;28;573;551;22;212;7
70220;Consulenza imprenditoriale e altra consulenza amministrativo-gestionale e pianificazione aziendale;Grande;13;12122;12122;0;213;127
70220;Consulenza imprenditoriale e altra consulenza amministrativo-gestionale e pianificazione aziendale;Media;32;3268;3260;8;180;27
70220;Consulenza imprenditoriale e altra consulenza amministrativo-gestionale e pianificazione aziendale;Micro;5148;6457;2264;4193;915;11
70220;Consulenza imprenditoriale e altra consulenza amministrativo-gestionale e pianificazione aziendale;Piccola;123;2154;2086;68;228;24
71110;Attività degli studi di architettura;Micro;4580;5100;219;4881;189;1
71110;Attività degli studi di architettura;Piccola;1;10;10;0;0;0
71121;Attività degli studi di ingegneria;Grande;1;712;712;0;19;0
71121;Attività degli studi di ingegneria;Media;4;311;311;0;22;1
71121;Attività degli studi di ingegneria;Micro;1649;1864;153;1711;51;0
71121;Attività degli studi di ingegneria;Piccola;11;258;242;16;27;1
71122;Servizi di progettazione di ingegneria integrata;Grande;5;3293;3293;0;61;35
71122;Servizi di progettazione di ingegneria integrata;Media;9;977;977;0;107;5
71122;Servizi di progettazione di ingegneria integrata;Micro;521;851;524;327;231;2
71122;Servizi di progettazione di ingegneria integrata;Piccola;50;1041;1003;38;216;11
71123;Attività tecniche svolte da geometri;Micro;497;583;67;516;11;0
71123;Attività tecniche svolte da geometri;Piccola;1;11;8;3;0;0
71124;Attività di cartografia e aerofotogrammetria;Micro;17;16;2;14;0;0
71124;Attività di cartografia e aerofotogrammetria;Piccola;1;10;9;1;1;0
71125;Attività di studio geologico e di prospezione geognostica e mineraria;Media;1;100;100;0;1;0
71125;Attività di studio geologico e di prospezione geognostica e mineraria;Micro;43;66;29;37;19;0
71125;Attività di studio geologico e di prospezione geognostica e mineraria;Piccola;4;70;70;0;0;0
71201;Collaudi ed analisi tecniche di prodotti;Grande;1;496;496;0;78;16
71201;Collaudi ed analisi tecniche di prodotti;Media;1;111;110;1;1;0
71201;Collaudi ed analisi tecniche di prodotti;Micro;98;170;94;76;15;2
71201;Collaudi ed analisi tecniche di prodotti;Piccola;11;248;239;9;19;0
71202;Controllo di qualità e certificazione di prodotti, processi e sistemi;Grande;3;1114;1114;0;282;10
71202;Controllo di qualità e certificazione di prodotti, processi e sistemi;Media;2;196;195;1;50;0
71202;Controllo di qualità e certificazione di prodotti, processi e sistemi;Micro;206;374;202;172;44;0
71202;Controllo di qualità e certificazione di prodotti, processi e sistemi;Piccola;19;384;370;14;72;22
72110;Ricerca e sviluppo sperimentale nel campo delle biotecnologie;Media;1;87;87;0;16;1
72110;Ricerca e sviluppo sperimentale nel campo delle biotecnologie;Micro;79;89;30;59;31;0
72110;Ricerca e sviluppo sperimentale nel campo delle biotecnologie;Piccola;7;182;179;3;27;0
72190;Altre attività di ricerca e sviluppo sperimentale nel campo delle scienze naturali e dell'ingegneria;Grande;1;338;338;0;24;18
72190;Altre attività di ricerca e sviluppo sperimentale nel campo delle scienze naturali e dell'ingegneria;Media;6;844;844;0;15;0
72190;Altre attività di ricerca e sviluppo sperimentale nel campo delle scienze naturali e dell'ingegneria;Micro;287;403;163;240;126;1
72190;Altre attività di ricerca e sviluppo sperimentale nel campo delle scienze naturali e dell'ingegneria;Piccola;14;260;257;3;8;0
72200;Ricerca e sviluppo sperimentale nel campo delle scienze sociali e umanistiche;Micro;249;291;71;220;88;0
72200;Ricerca e sviluppo sperimentale nel campo delle scienze sociali e umanistiche;Piccola;5;91;85;6;48;0
73110;Agenzie pubblicitarie;Media;30;2617;2615;2;490;9
73110;Agenzie pubblicitarie;Micro;1562;2616;1135;1481;977;1
73110;Agenzie pubblicitarie;Piccola;126;2769;2658;111;1138;11
73120;Attività delle concessionarie e degli altri intermediari di servizi pubblicitari;Grande;2;627;627;0;9;4
73120;Attività delle concessionarie e degli altri intermediari di servizi pubblicitari;Media;3;338;338;0;42;14
73120;Attività delle concessionarie e degli altri intermediari di servizi pubblicitari;Micro;358;603;332;271;178;2
73120;Attività delle concessionarie e degli altri intermediari di servizi pubblicitari;Piccola;42;796;770;26;94;3
73200;Ricerche di mercato e sondaggi di opinione;Grande;1;343;343;0;41;0
73200;Ricerche di mercato e sondaggi di opinione;Media;13;1490;1490;0;1873;1
73200;Ricerche di mercato e sondaggi di opinione;Micro;565;846;332;514;288;0
73200;Ricerche di mercato e sondaggi di opinione;Piccola;41;835;811;24;204;7
74101;Attività di design di moda e design industriale;Grande;2;1161;1159;2;82;14
74101;Attività di design di moda e design industriale;Media;4;375;375;0;32;2
74101;Attività di design di moda e design industriale;Micro;764;970;224;746;149;0
74101;Attività di design di moda e design industriale;Piccola;13;214;205;9;77;0
74102;Attività dei disegnatori grafici;Micro;1128;1501;312;1189;206;0
74102;Attività dei disegnatori grafici;Piccola;24;373;337;36;152;1
74103;Attività dei disegnatori tecnici;Micro;324;379;44;335;16;0
74103;Attività dei disegnatori tecnici;Piccola;3;45;43;2;1;0
74109;Altre attività di design;Micro;414;475;74;401;32;0
74109;Altre attività di design;Piccola;3;37;32;5;5;0
74201;Attività di riprese fotografiche;Micro;993;1148;101;1047;31;3
74201;Attività di riprese fotografiche;Piccola;1;17;16;1;0;0
74202;Laboratori fotografici per lo sviluppo e la stampa;Micro;106;213;77;136;5;0
74202;Laboratori fotografici per lo sviluppo e la stampa;Piccola;6;142;133;9;5;7
74300;Traduzione e interpretariato;Micro;638;763;128;635;27;3
74300;Traduzione e interpretariato;Piccola;6;79;71;8;18;0
74901;Consulenza agraria;Micro;70;77;4;73;0;0
74902;Consulenza in materia di sicurezza;Media;1;80;80;0;0;0
74902;Consulenza in materia di sicurezza;Micro;269;418;183;235;55;2
74902;Consulenza in materia di sicurezza;Piccola;8;136;127;9;59;0
74909;Altre attività di assistenza e consulenza professionale, scientifica e tecnica nca;Media;6;410;409;1;450;19
74909;Altre attività di assistenza e consulenza professionale, scientifica e tecnica nca;Micro;4981;6071;1658;4413;676;69
74909;Altre attività di assistenza e consulenza professionale, scientifica e tecnica nca;Piccola;106;1872;1796;76;242;7
75000;Servizi veterinari;Micro;375;433;14;419;2;1
77110;Noleggio di autovetture ed autoveicoli leggeri;Media;1;70;70;0;4;4
77110;Noleggio di autovetture ed autoveicoli leggeri;Micro;81;133;87;46;14;1
77110;Noleggio di autovetture ed autoveicoli leggeri;Piccola;3;83;80;3;3;0
77120;Noleggio di autocarri e di altri veicoli pesanti;Micro;8;16;12;4;0;1
77210;Noleggio di attrezzature sportive e ricreative;Micro;32;24;9;15;2;0
77210;Noleggio di attrezzature sportive e ricreative;Piccola;1;11;11;0;1;0
77220;Noleggio di videocassette, Cd, Dvd e dischi contenenti audiovisivi o videogame;Grande;1;790;790;0;0;0
77220;Noleggio di videocassette, Cd, Dvd e dischi contenenti audiovisivi o videogame;Micro;25;34;4;30;2;0
77291;Noleggio di biancheria da tavola, da letto, da bagno e di articoli di vestiario;Micro;9;16;5;11;1;0
77291;Noleggio di biancheria da tavola, da letto, da bagno e di articoli di vestiario;Piccola;1;22;22;0;0;1
77299;Noleggio di altri beni per uso personale e domestico nca (escluse le attrezzature sportive e ricreative);Micro;13;15;6;9;1;0
77310;Noleggio di macchine e attrezzature agricole;Micro;1;1;0;1;0;0
77320;Noleggio di macchine e attrezzature per lavori edili e di genio civile;Micro;27;53;28;25;6;0
77320;Noleggio di macchine e attrezzature per lavori edili e di genio civile;Piccola;4;73;69;4;1;0
77330;Noleggio di macchine e attrezzature per ufficio (inclusi i computer);Media;1;202;202;0;1;1
77330;Noleggio di macchine e attrezzature per ufficio (inclusi i computer);Micro;32;48;26;22;7;0
77330;Noleggio di macchine e attrezzature per ufficio (inclusi i computer);Piccola;2;32;32;0;0;0
77340;Noleggio di mezzi di trasporto marittimo e fluviale;Micro;33;56;43;13;3;0
77350;Noleggio di mezzi di trasporto aereo;Micro;20;22;18;4;8;0
77391;Noleggio di altri mezzi di trasporto terrestri;Media;1;80;80;0;0;0
77391;Noleggio di altri mezzi di trasporto terrestri;Micro;6;10;9;1;1;0
77391;Noleggio di altri mezzi di trasporto terrestri;Piccola;1;23;23;0;1;0
77399;Noleggio di altre macchine e attrezzature;Media;2;128;128;0;13;0
77399;Noleggio di altre macchine e attrezzature;Micro;142;223;125;98;25;0
77399;Noleggio di altre macchine e attrezzature;Piccola;15;274;259;15;14;7
77400;Concessione dei diritti di sfruttamento di proprietà intellettuale e prodotti simili (escluse le opere protette dal copyright);Media;1;68;67;1;7;0
77400;Concessione dei diritti di sfruttamento di proprietà intellettuale e prodotti simili (escluse le opere protette dal copyright);Micro;45;53;23;30;6;0
77400;Concessione dei diritti di sfruttamento di proprietà intellettuale e prodotti simili (escluse le opere protette dal copyright);Piccola;5;127;125;2;7;0
78100;Servizi di ricerca, selezione, collocamento e supporto per il ricollocamento di personale;Media;5;373;373;0;14;7
78100;Servizi di ricerca, selezione, collocamento e supporto per il ricollocamento di personale;Micro;288;469;233;236;116;0
78100;Servizi di ricerca, selezione, collocamento e supporto per il ricollocamento di personale;Piccola;27;482;464;18;169;2
78200;Attività delle agenzie di fornitura di lavoro temporaneo (interinale);Grande;20;100238;100230;8;208;3001
78200;Attività delle agenzie di fornitura di lavoro temporaneo (interinale);Media;1;70;70;0;0;3
78200;Attività delle agenzie di fornitura di lavoro temporaneo (interinale);Micro;3;7;2;5;13;11
79110;Attività delle agenzie di viaggio;Grande;2;814;814;0;7;4
79110;Attività delle agenzie di viaggio;Media;8;676;675;1;19;2
79110;Attività delle agenzie di viaggio;Micro;226;509;285;224;195;0
79110;Attività delle agenzie di viaggio;Piccola;28;484;466;18;112;0
79120;Attività dei tour operator;Grande;1;311;311;0;4;0
79120;Attività dei tour operator;Media;3;215;212;3;5;0
79120;Attività dei tour operator;Micro;207;585;385;200;146;1
79120;Attività dei tour operator;Piccola;29;573;543;30;43;0
79901;Altri servizi di prenotazione e altre attività di assistenza turistica non svolte dalle agenzie di viaggio;Media;3;305;304;1;7;0
79901;Altri servizi di prenotazione e altre attività di assistenza turistica non svolte dalle agenzie di viaggio;Micro;78;110;42;68;19;0
79901;Altri servizi di prenotazione e altre attività di assistenza turistica non svolte dalle agenzie di viaggio;Piccola;5;95;92;3;3;0
79902;Attività delle guide e degli accompagnatori turistici;Micro;93;92;0;92;35;0
80100;Servizi di vigilanza privata;Grande;5;6674;6672;2;35;50
80100;Servizi di vigilanza privata;Media;10;825;758;67;33;0
80100;Servizi di vigilanza privata;Micro;44;103;68;35;10;0
80100;Servizi di vigilanza privata;Piccola;14;313;302;11;50;0
80200;Servizi connessi ai sistemi di vigilanza;Micro;6;8;6;2;3;0
80200;Servizi connessi ai sistemi di vigilanza;Piccola;3;56;56;0;1;0
80300;Servizi di investigazione privata;Micro;68;123;55;68;40;0
80300;Servizi di investigazione privata;Piccola;11;185;176;9;119;0
81100;Servizi integrati di gestione agli edifici;Grande;1;277;277;0;0;0
81100;Servizi integrati di gestione agli edifici;Media;3;335;335;0;8;0
81100;Servizi integrati di gestione agli edifici;Micro;63;122;76;46;22;0
81100;Servizi integrati di gestione agli edifici;Piccola;9;185;136;49;3;0
81210;Pulizia generale (non specializzata) di edifici;Grande;11;8856;8845;11;32;39
81210;Pulizia generale (non specializzata) di edifici;Media;72;8335;8277;58;29;156
81210;Pulizia generale (non specializzata) di edifici;Micro;1292;3227;1919;1308;60;31
81210;Pulizia generale (non specializzata) di edifici;Piccola;248;4915;4653;262;32;27
81220;Attività di pulizia specializzata di edifici e di impianti e macchinari industriali;Grande;3;11091;11089;2;6;231
81220;Attività di pulizia specializzata di edifici e di impianti e macchinari industriali;Media;4;283;272;11;4;0
81220;Attività di pulizia specializzata di edifici e di impianti e macchinari industriali;Micro;20;39;33;6;0;0
81220;Attività di pulizia specializzata di edifici e di impianti e macchinari industriali;Piccola;9;154;149;5;1;0
81291;Servizi di disinfestazione;Micro;41;131;79;52;6;0
81291;Servizi di disinfestazione;Piccola;7;148;136;12;1;1
81299;Attività di pulizia nca;Grande;3;2004;2004;0;17;0
81299;Attività di pulizia nca;Media;19;2336;2332;4;17;16
81299;Attività di pulizia nca;Micro;148;320;199;121;3;0
81299;Attività di pulizia nca;Piccola;37;695;658;37;12;0
81300;Cura e manutenzione del paesaggio (inclusi parchi, giardini e aiuole);Grande;1;267;0;267;0;0
81300;Cura e manutenzione del paesaggio (inclusi parchi, giardini e aiuole);Micro;138;254;95;159;5;0
81300;Cura e manutenzione del paesaggio (inclusi parchi, giardini e aiuole);Piccola;6;101;97;4;2;0
82110;Servizi integrati di supporto per le funzioni d'ufficio| uffici-residence;Media;4;383;383;0;11;21
82110;Servizi integrati di supporto per le funzioni d'ufficio| uffici-residence;Micro;160;241;132;109;13;1
82110;Servizi integrati di supporto per le funzioni d'ufficio| uffici-residence;Piccola;10;141;126;15;11;1
82190;Servizi di fotocopiatura, preparazione di documenti e altre attività di supporto specializzate per le funzioni d'ufficio;Micro;309;556;219;337;194;0
82190;Servizi di fotocopiatura, preparazione di documenti e altre attività di supporto specializzate per le funzioni d'ufficio;Piccola;8;129;126;3;4;0
82200;Attività dei call center;Grande;3;2155;2153;2;555;361
82200;Attività dei call center;Media;7;836;832;4;568;0
82200;Attività dei call center;Micro;48;102;71;31;203;0
82200;Attività dei call center;Piccola;8;96;93;3;341;12
82300;Organizzazione di convegni e fiere;Media;3;392;237;155;29;5
82300;Organizzazione di convegni e fiere;Micro;538;975;563;412;350;0
82300;Organizzazione di convegni e fiere;Piccola;39;781;756;25;307;0
82911;Attività di agenzie di recupero crediti;Media;6;638;634;4;61;61
82911;Attività di agenzie di recupero crediti;Micro;99;184;101;83;57;0
82911;Attività di agenzie di recupero crediti;Piccola;10;189;180;9;45;6
82912;Agenzie di informazioni commerciali;Grande;1;799;799;0;68;3
82912;Agenzie di informazioni commerciali;Micro;100;173;100;73;105;0
82912;Agenzie di informazioni commerciali;Piccola;7;155;149;6;30;1
82921;Imballaggio e confezionamento di generi alimentari;Micro;7;18;13;5;0;0
82921;Imballaggio e confezionamento di generi alimentari;Piccola;2;56;55;1;0;0
82922;Imballaggio e confezionamento di generi non alimentari;Media;10;938;936;2;2;0
82922;Imballaggio e confezionamento di generi non alimentari;Micro;55;140;111;29;4;0
82922;Imballaggio e confezionamento di generi non alimentari;Piccola;27;643;576;67;6;9
82991;Imprese di gestione esattoriale;Grande;2;3339;3338;1;140;0
82991;Imprese di gestione esattoriale;Media;1;109;107;2;4;0
82992;Agenzie di distribuzione di libri, giornali e riviste;Media;1;154;154;0;3;0
82992;Agenzie di distribuzione di libri, giornali e riviste;Micro;29;66;45;21;56;0
82992;Agenzie di distribuzione di libri, giornali e riviste;Piccola;4;94;93;1;13;0
82993;Servizi di gestione di pubblici mercati e pese pubbliche;Media;1;53;53;0;3;0
82993;Servizi di gestione di pubblici mercati e pese pubbliche;Micro;8;0;0;0;1;0
82994;Richiesta certificati e disbrigo pratiche;Media;1;178;178;0;0;1
82994;Richiesta certificati e disbrigo pratiche;Micro;192;440;207;233;22;1
82994;Richiesta certificati e disbrigo pratiche;Piccola;10;168;149;19;8;0
82999;Altri servizi di sostegno alle imprese;Grande;5;1564;1562;2;20;0
82999;Altri servizi di sostegno alle imprese;Media;59;5466;5415;51;199;68
82999;Altri servizi di sostegno alle imprese;Micro;3792;5144;2179;2965;702;162
82999;Altri servizi di sostegno alle imprese;Piccola;209;4500;4369;131;460;13
85100;Istruzione di grado preparatorio: scuole dell'infanzia, scuole speciali collegate a quelle primarie;Media;2;133;131;2;36;0
85100;Istruzione di grado preparatorio: scuole dell'infanzia, scuole speciali collegate a quelle primarie;Micro;44;188;130;58;82;0
85100;Istruzione di grado preparatorio: scuole dell'infanzia, scuole speciali collegate a quelle primarie;Piccola;12;178;165;13;22;0
85200;Istruzione primaria: scuole elementari;Media;1;170;170;0;46;0
85200;Istruzione primaria: scuole elementari;Piccola;4;89;82;7;19;0
85311;Istruzione secondaria di primo grado: scuole medie;Media;1;124;124;0;24;0
85311;Istruzione secondaria di primo grado: scuole medie;Micro;1;1;0;1;0;0
85312;Istruzione secondaria di secondo grado di formazione generale: licei;Media;2;283;279;4;85;0
85312;Istruzione secondaria di secondo grado di formazione generale: licei;Micro;4;7;2;5;27;0
85312;Istruzione secondaria di secondo grado di formazione generale: licei;Piccola;5;83;77;6;46;0
85320;Istruzione secondaria di secondo grado di formazione tecnica, professionale e artistica (istituti tecnici, professionali, artistici eccetera);Media;1;87;86;1;18;0
85320;Istruzione secondaria di secondo grado di formazione tecnica, professionale e artistica (istituti tecnici, professionali, artistici eccetera);Micro;25;48;29;19;74;0
85320;Istruzione secondaria di secondo grado di formazione tecnica, professionale e artistica (istituti tecnici, professionali, artistici eccetera);Piccola;1;22;21;1;15;0
85410;Istruzione e formazione tecnica superiore (IFTS);Micro;25;37;21;16;3;0
85410;Istruzione e formazione tecnica superiore (IFTS);Piccola;4;78;76;2;40;0
85420;Istruzione universitaria e post-universitaria| accademie e conservatori;Media;1;66;66;0;33;0
85420;Istruzione universitaria e post-universitaria| accademie e conservatori;Micro;9;40;31;9;11;0
85510;Corsi sportivi e ricreativi;Micro;119;125;9;116;1;0
85520;Formazione culturale;Micro;115;152;35;117;148;0
85530;Autoscuole, scuole di pilotaggio e nautiche;Micro;104;246;66;180;22;0
85530;Autoscuole, scuole di pilotaggio e nautiche;Piccola;2;34;34;0;0;0
85592;Corsi di formazione e corsi di aggiornamento professionale;Media;3;360;360;0;15;0
85592;Corsi di formazione e corsi di aggiornamento professionale;Micro;595;876;398;478;257;6
85592;Corsi di formazione e corsi di aggiornamento professionale;Piccola;19;360;336;24;178;4
85593;Scuole e corsi di lingua;Media;1;73;72;1;4;0
85593;Scuole e corsi di lingua;Micro;115;162;43;119;154;0
85593;Scuole e corsi di lingua;Piccola;3;51;50;1;176;0
85599;Altri servizi di istruzione nca;Micro;391;565;187;378;223;0
85599;Altri servizi di istruzione nca;Piccola;16;329;315;14;111;0
85600;Attività di supporto all'istruzione;Micro;47;66;14;52;14;0
85600;Attività di supporto all'istruzione;Piccola;2;51;48;3;61;0
86101;Ospedali e case di cura generici;Grande;3;2230;2230;0;62;17
86101;Ospedali e case di cura generici;Media;2;362;362;0;1;1
86101;Ospedali e case di cura generici;Micro;11;25;18;7;2;0
86101;Ospedali e case di cura generici;Piccola;1;24;23;1;1;1
86102;Ospedali e case di cura specialistici;Grande;3;1499;1498;1;73;20
86102;Ospedali e case di cura specialistici;Media;2;141;140;1;3;0
86102;Ospedali e case di cura specialistici;Micro;11;27;21;6;2;0
86102;Ospedali e case di cura specialistici;Piccola;3;80;79;1;4;3
86104;Ospedali e case di cura per lunga degenza;Grande;2;2207;2207;0;89;0
86104;Ospedali e case di cura per lunga degenza;Micro;6;17;15;2;1;1
86104;Ospedali e case di cura per lunga degenza;Piccola;1;22;22;0;0;0
86210;Servizi degli studi medici di medicina generale;Micro;1478;1709;219;1490;56;1
86210;Servizi degli studi medici di medicina generale;Piccola;1;10;10;0;1;0
86220;Studi medici specialistici e poliambulatori;Media;1;71;71;0;2;9
86220;Studi medici specialistici e poliambulatori;Micro;4025;4597;604;3993;99;4
86220;Studi medici specialistici e poliambulatori;Piccola;16;250;240;10;25;0
86230;Attività degli studi odontoiatrici;Micro;2018;4210;2070;2140;46;1
86230;Attività degli studi odontoiatrici;Piccola;24;328;299;29;10;2
86901;Laboratori di analisi cliniche, laboratori radiografici ed altri centri di diagnostica per immagini;Grande;1;313;313;0;4;0
86901;Laboratori di analisi cliniche, laboratori radiografici ed altri centri di diagnostica per immagini;Media;3;269;265;4;14;0
86901;Laboratori di analisi cliniche, laboratori radiografici ed altri centri di diagnostica per immagini;Micro;243;406;201;205;46;0
86901;Laboratori di analisi cliniche, laboratori radiografici ed altri centri di diagnostica per immagini;Piccola;11;176;169;7;7;0
86902;Attività paramediche indipendenti;Media;2;185;0;185;0;0
86902;Attività paramediche indipendenti;Micro;1425;1572;145;1427;28;1
86902;Attività paramediche indipendenti;Piccola;9;139;117;22;26;0
86903;Attività svolta da psicologi;Micro;1760;1792;4;1788;3;0
86903;Attività svolta da psicologi;Piccola;2;22;12;10;1;0
86904;Servizi di ambulanza, delle banche del sangue, degli ambulatori tricologici e altri servizi sanitari nca;Media;1;125;125;0;41;5
86904;Servizi di ambulanza, delle banche del sangue, degli ambulatori tricologici e altri servizi sanitari nca;Micro;31;44;20;24;5;0
86904;Servizi di ambulanza, delle banche del sangue, degli ambulatori tricologici e altri servizi sanitari nca;Piccola;1;17;16;1;0;0
87100;Strutture di assistenza infermieristica residenziale per anziani;Grande;3;2473;2473;0;19;6
87100;Strutture di assistenza infermieristica residenziale per anziani;Micro;8;9;6;3;4;0
87100;Strutture di assistenza infermieristica residenziale per anziani;Piccola;1;17;17;0;5;0
87200;Strutture di assistenza residenziale per persone affette da ritardi mentali, disturbi mentali o che abusano di sostanze stupefacenti;Micro;2;2;0;2;1;0
87300;Strutture di assistenza residenziale per anziani e disabili;Grande;1;333;333;0;0;5
87300;Strutture di assistenza residenziale per anziani e disabili;Media;1;103;103;0;2;0
87300;Strutture di assistenza residenziale per anziani e disabili;Micro;11;25;24;1;9;0
87300;Strutture di assistenza residenziale per anziani e disabili;Piccola;4;109;108;1;37;0
87900;Altre strutture di assistenza sociale residenziale;Micro;14;19;15;4;3;0
87900;Altre strutture di assistenza sociale residenziale;Piccola;1;11;0;11;9;0
88100;Assistenza sociale non residenziale per anziani e disabili;Grande;1;253;253;0;0;0
88100;Assistenza sociale non residenziale per anziani e disabili;Media;1;189;189;0;4;13
88100;Assistenza sociale non residenziale per anziani e disabili;Micro;25;48;28;20;17;0
88100;Assistenza sociale non residenziale per anziani e disabili;Piccola;3;31;19;12;4;0
88910;Servizi di asili nido| assistenza diurna per minori disabili;Micro;85;268;184;84;120;0
88910;Servizi di asili nido| assistenza diurna per minori disabili;Piccola;6;91;84;7;31;0
88990;Altre attività di assistenza sociale non residenziale nca;Media;2;202;202;0;42;0
88990;Altre attività di assistenza sociale non residenziale nca;Micro;48;59;15;44;21;0
88990;Altre attività di assistenza sociale non residenziale nca;Piccola;1;26;26;0;0;0
90010;Rappresentazioni artistiche;Micro;1138;1173;78;1095;44;0
90010;Rappresentazioni artistiche;Piccola;4;75;74;1;10;3
90020;Attività di supporto alle rappresentazioni artistiche;Micro;455;529;101;428;30;0
90020;Attività di supporto alle rappresentazioni artistiche;Piccola;6;168;163;5;1;0
90030;Creazioni artistiche e letterarie;Micro;1428;1526;73;1453;70;1
90030;Creazioni artistiche e letterarie;Piccola;6;84;80;4;3;0
90040;Gestione di teatri, sale da concerto e altre strutture artistiche;Micro;19;28;23;5;4;0
90040;Gestione di teatri, sale da concerto e altre strutture artistiche;Piccola;11;245;239;6;2;0
91010;Attività di biblioteche ed archivi;Media;1;186;169;17;35;0
91010;Attività di biblioteche ed archivi;Micro;29;44;14;30;2;0
91010;Attività di biblioteche ed archivi;Piccola;1;25;25;0;0;1
91020;Attività di musei;Micro;3;7;4;3;1;0
91030;Gestione di luoghi e monumenti storici e attrazioni simili;Micro;1;0;0;0;0;0
91040;Attività degli orti botanici, dei giardini zoologici e delle riserve naturali;Micro;2;9;8;1;1;0
92000;Attività riguardanti le lotterie, le scommesse, le case da gioco;Grande;3;1144;1144;0;36;23
92000;Attività riguardanti le lotterie, le scommesse, le case da gioco;Media;2;310;310;0;11;10
92000;Attività riguardanti le lotterie, le scommesse, le case da gioco;Micro;121;342;211;131;122;1
92000;Attività riguardanti le lotterie, le scommesse, le case da gioco;Piccola;12;202;195;7;82;8
93111;Gestione di stadi;Micro;1;5;5;0;0;0
93112;Gestione di piscine;Micro;5;11;9;2;6;0
93113;Gestione di impianti sportivi polivalenti;Media;1;111;111;0;0;0
93113;Gestione di impianti sportivi polivalenti;Micro;34;86;68;18;34;0
93113;Gestione di impianti sportivi polivalenti;Piccola;5;84;79;5;5;0
93119;Gestione di altri impianti sportivi nca;Media;2;267;267;0;194;86
93119;Gestione di altri impianti sportivi nca;Micro;17;32;25;7;14;0
93119;Gestione di altri impianti sportivi nca;Piccola;2;28;26;2;1;0
93120;Attività di club sportivi;Media;1;195;195;0;62;1
93120;Attività di club sportivi;Micro;10;6;1;5;2;0
93120;Attività di club sportivi;Piccola;2;28;28;0;7;2
93130;Gestione di palestre;Media;1;174;174;0;26;0
93130;Gestione di palestre;Micro;111;196;94;102;150;0
93130;Gestione di palestre;Piccola;6;96;93;3;1;0
93191;Enti e organizzazioni sportive, promozione di eventi sportivi;Media;1;217;217;0;50;0
93191;Enti e organizzazioni sportive, promozione di eventi sportivi;Micro;104;139;66;73;33;0
93191;Enti e organizzazioni sportive, promozione di eventi sportivi;Piccola;3;77;74;3;45;0
93199;Attività sportive nca;Micro;194;210;28;182;4;0
93210;Parchi di divertimento e parchi tematici;Micro;14;26;12;14;1;0
93291;Discoteche, sale da ballo night-club e simili;Media;1;60;60;0;0;15
93291;Discoteche, sale da ballo night-club e simili;Micro;45;129;102;27;12;0
93291;Discoteche, sale da ballo night-club e simili;Piccola;27;495;470;25;11;0
93292;Gestione di stabilimenti balneari: marittimi, lacuali e fluviali;Micro;5;2;1;1;1;0
93293;Sale giochi e biliardi;Micro;48;99;60;39;8;2
93293;Sale giochi e biliardi;Piccola;2;33;26;7;4;0
93299;Altre attività di intrattenimento e di divertimento nca;Grande;1;518;518;0;1;0
93299;Altre attività di intrattenimento e di divertimento nca;Micro;354;429;136;293;146;0
93299;Altre attività di intrattenimento e di divertimento nca;Piccola;14;307;297;10;33;0
95110;Riparazione e manutenzione di computer e periferiche;Grande;1;329;329;0;0;0
95110;Riparazione e manutenzione di computer e periferiche;Media;1;85;85;0;5;0
95110;Riparazione e manutenzione di computer e periferiche;Micro;97;155;64;91;58;0
95110;Riparazione e manutenzione di computer e periferiche;Piccola;6;101;92;9;12;0
95120;Riparazione e manutenzione di apparecchiature per le comunicazioni;Media;2;102;101;1;0;60
95120;Riparazione e manutenzione di apparecchiature per le comunicazioni;Micro;77;152;74;78;13;0
95120;Riparazione e manutenzione di apparecchiature per le comunicazioni;Piccola;5;78;70;8;8;0
95210;Riparazione di prodotti elettronici di consumo audio e video;Media;1;52;51;1;0;2
95210;Riparazione di prodotti elettronici di consumo audio e video;Micro;32;58;15;43;0;0
95210;Riparazione di prodotti elettronici di consumo audio e video;Piccola;1;11;10;1;0;0
95220;Riparazione di elettrodomestici e di articoli per la casa e il giardinaggio;Micro;64;161;70;91;4;0
95220;Riparazione di elettrodomestici e di articoli per la casa e il giardinaggio;Piccola;2;30;29;1;0;0
95230;Riparazione di calzature e articoli da viaggio in pelle, cuoio o in altri materiali simili;Media;1;188;187;1;2;0
95230;Riparazione di calzature e articoli da viaggio in pelle, cuoio o in altri materiali simili;Micro;149;164;7;157;0;0
95240;Riparazione di mobili e di oggetti di arredamento| laboratori di tappezzeria;Micro;95;142;28;114;5;0
95250;Riparazione di orologi e di gioielli;Micro;101;143;19;124;1;0
95250;Riparazione di orologi e di gioielli;Piccola;1;10;9;1;1;0
95290;Riparazione di altri beni per uso personale e per la casa;Micro;310;499;141;358;4;0
95290;Riparazione di altri beni per uso personale e per la casa;Piccola;3;52;44;8;1;0
96011;Attività delle lavanderie industriali;Grande;1;707;707;0;5;13
96011;Attività delle lavanderie industriali;Micro;30;74;38;36;1;0
96011;Attività delle lavanderie industriali;Piccola;8;115;105;10;3;12
96012;Altre lavanderie, tintorie;Micro;592;923;259;664;1;2
96012;Altre lavanderie, tintorie;Piccola;4;77;70;7;0;0
96020;Servizi degli acconciatori, manicure, pedicure e trattamenti estetici;Media;1;113;111;2;0;0
96020;Servizi degli acconciatori, manicure, pedicure e trattamenti estetici;Micro;2747;6210;2894;3316;102;0
96020;Servizi degli acconciatori, manicure, pedicure e trattamenti estetici;Piccola;95;1487;1339;148;20;0
96030;Servizi di pompe funebri e attività connesse;Micro;85;177;85;92;18;0
96030;Servizi di pompe funebri e attività connesse;Piccola;6;103;99;4;10;0
96041;Servizi di centri per il benessere fisico (esclusi gli stabilimenti termali);Micro;464;1100;605;495;40;5
96041;Servizi di centri per il benessere fisico (esclusi gli stabilimenti termali);Piccola;14;218;208;10;7;0
96042;Stabilimenti termali;Micro;2;6;2;4;0;0
96042;Stabilimenti termali;Piccola;1;10;8;2;0;0
96090;Attività di servizi per la persona nca;Media;2;167;167;0;0;0
96090;Attività di servizi per la persona nca;Micro;1094;1634;704;930;201;3
96090;Attività di servizi per la persona nca;Piccola;71;1319;1242;77;200;6
